ID,Флаг дозвона,Флаг продажи,Расходы,PV,NPV
0,0,0,38,0,-38
1,1,0,89,0,-89
2,1,0,52,0,-52
3,0,0,5,0,-5
4,1,0,12,0,-12
5,1,0,19,0,-19
6,0,0,12,0,-12
7,1,0,37,0,-37
8,1,1,314,1317,1003
9,1,0,42,0,-42
10,1,1,101,1960,1859
11,1,0,54,0,-54
12,1,0,56,0,-56
13,0,0,116,0,-116
14,1,1,427,1754,1327
15,1,1,246,1451,1205
16,1,1,811,1443,632
17,1,0,12,0,-12
18,0,0,28,0,-28
19,0,0,8,0,-8
20,1,1,121,1370,1249
21,0,0,1,0,-1
22,0,0,3,0,-3
23,0,0,17,0,-17
24,1,1,187,1658,1471
25,1,0,179,0,-179
26,0,0,53,0,-53
27,1,0,97,0,-97
28,1,0,58,0,-58
29,1,1,2054,1234,-820
30,1,1,481,1243,762
31,0,0,15,0,-15
32,1,1,343,1261,918
33,1,1,297,1303,1006
34,1,1,1056,1831,775
35,1,1,600,1273,673
36,1,1,277,1338,1061
37,1,0,14,0,-14
38,1,1,611,1207,596
39,1,0,15,0,-15
40,0,0,117,0,-117
41,0,0,44,0,-44
42,0,0,89,0,-89
43,0,0,5,0,-5
44,1,1,476,3106,2630
45,1,1,380,1215,835
46,1,1,183,1422,1239
47,1,0,25,0,-25
48,1,0,14,0,-14
49,1,1,819,1273,454
50,0,0,6,0,-6
51,1,1,1561,1607,46
52,0,0,192,0,-192
53,1,0,179,0,-179
54,1,1,662,1591,929
55,1,0,144,0,-144
56,1,1,258,1344,1086
57,1,0,24,0,-24
58,0,0,8,0,-8
59,1,0,74,0,-74
60,0,0,0,0,0
61,1,0,9,0,-9
62,0,0,19,0,-19
63,1,0,93,0,-93
64,1,1,130,1310,1180
65,1,0,28,0,-28
66,0,0,25,0,-25
67,1,0,1,0,-1
68,0,0,8,0,-8
69,0,0,2,0,-2
70,1,1,395,1246,851
71,0,0,46,0,-46
72,0,0,160,0,-160
73,0,0,49,0,-49
74,1,1,112,1536,1424
75,1,0,6,0,-6
76,1,0,2,0,-2
77,0,0,21,0,-21
78,0,0,1,0,-1
79,1,1,3014,1521,-1493
80,1,1,246,1458,1212
81,1,0,58,0,-58
82,1,0,44,0,-44
83,1,1,934,1408,474
84,1,1,44,1673,1629
85,1,1,1010,1510,500
86,1,1,250,1899,1649
87,1,0,10,0,-10
88,1,0,10,0,-10
89,1,1,815,1371,556
90,0,0,98,0,-98
91,1,1,1582,1669,87
92,1,0,158,0,-158
93,0,0,11,0,-11
94,1,1,47,1268,1221
95,1,1,625,1205,580
96,0,0,32,0,-32
97,1,1,1369,1803,434
98,0,0,70,0,-70
99,0,0,13,0,-13
100,0,0,37,0,-37
101,0,0,13,0,-13
102,1,1,1827,1560,-267
103,0,0,24,0,-24
104,1,1,1399,1776,377
105,1,1,686,1388,702
106,1,1,342,1546,1204
107,0,0,45,0,-45
108,0,0,19,0,-19
109,1,0,26,0,-26
110,0,0,58,0,-58
111,0,0,44,0,-44
112,1,0,37,0,-37
113,1,1,1093,1237,144
114,1,1,165,1283,1118
115,1,1,1015,1725,710
116,1,1,146,1220,1074
117,1,0,150,0,-150
118,0,0,39,0,-39
119,0,0,211,0,-211
120,1,1,1882,2404,522
121,1,0,17,0,-17
122,0,0,0,0,0
123,1,1,417,1362,945
124,0,0,37,0,-37
125,1,1,245,1485,1240
126,0,0,6,0,-6
127,1,0,165,0,-165
128,1,1,711,1718,1007
129,0,0,183,0,-183
130,0,0,61,0,-61
131,0,0,96,0,-96
132,1,0,9,0,-9
133,0,0,72,0,-72
134,1,1,949,1380,431
135,1,1,1323,1978,655
136,1,0,9,0,-9
137,0,0,81,0,-81
138,1,1,55,1615,1560
139,0,0,106,0,-106
140,1,0,75,0,-75
141,1,0,34,0,-34
142,1,0,79,0,-79
143,1,0,39,0,-39
144,1,1,1034,1844,810
145,1,0,57,0,-57
146,1,0,4,0,-4
147,1,0,13,0,-13
148,1,0,6,0,-6
149,0,0,54,0,-54
150,1,0,85,0,-85
151,0,0,40,0,-40
152,0,0,31,0,-31
153,1,1,896,1843,947
154,0,0,61,0,-61
155,1,1,637,1540,903
156,0,0,31,0,-31
157,0,0,111,0,-111
158,1,1,253,1420,1167
159,0,0,4,0,-4
160,0,0,98,0,-98
161,1,0,0,0,0
162,1,0,19,0,-19
163,1,1,1237,1230,-7
164,1,1,622,1727,1105
165,0,0,7,0,-7
166,1,1,1162,1460,298
167,1,0,75,0,-75
168,0,0,68,0,-68
169,1,1,874,1275,401
170,0,0,110,0,-110
171,0,0,45,0,-45
172,0,0,144,0,-144
173,1,0,21,0,-21
174,1,0,115,0,-115
175,0,0,31,0,-31
176,0,0,27,0,-27
177,0,0,58,0,-58
178,0,0,124,0,-124
179,1,0,14,0,-14
180,1,0,22,0,-22
181,1,1,1237,2389,1152
182,1,0,4,0,-4
183,0,0,50,0,-50
184,0,0,9,0,-9
185,1,0,79,0,-79
186,0,0,194,0,-194
187,1,0,10,0,-10
188,0,0,19,0,-19
189,0,0,32,0,-32
190,1,1,262,1216,954
191,0,0,64,0,-64
192,1,1,410,1697,1287
193,0,0,20,0,-20
194,1,0,10,0,-10
195,0,0,87,0,-87
196,1,1,310,1378,1068
197,1,0,1,0,-1
198,1,0,25,0,-25
199,0,0,24,0,-24
200,0,0,28,0,-28
201,1,1,354,2134,1780
202,1,1,624,1273,649
203,1,1,39,1923,1884
204,1,0,10,0,-10
205,1,0,10,0,-10
206,0,0,30,0,-30
207,0,0,12,0,-12
208,0,0,62,0,-62
209,1,1,541,1931,1390
210,1,1,287,1222,935
211,0,0,17,0,-17
212,0,0,11,0,-11
213,1,0,94,0,-94
214,1,1,515,5802,5287
215,0,0,83,0,-83
216,1,1,56,1391,1335
217,1,0,31,0,-31
218,0,0,3,0,-3
219,0,0,86,0,-86
220,0,0,21,0,-21
221,1,0,32,0,-32
222,1,0,158,0,-158
223,1,1,58,1319,1261
224,1,1,2018,1398,-620
225,1,0,44,0,-44
226,0,0,10,0,-10
227,1,0,29,0,-29
228,0,0,45,0,-45
229,1,0,111,0,-111
230,1,1,148,1702,1554
231,0,0,7,0,-7
232,0,0,15,0,-15
233,1,0,11,0,-11
234,0,0,56,0,-56
235,1,1,1062,1261,199
236,1,1,562,1283,721
237,0,0,99,0,-99
238,1,1,179,1264,1085
239,1,1,1350,1362,12
240,1,0,213,0,-213
241,0,0,62,0,-62
242,1,1,183,2348,2165
243,0,0,62,0,-62
244,0,0,37,0,-37
245,1,1,461,1611,1150
246,1,0,19,0,-19
247,1,1,253,1312,1059
248,0,0,36,0,-36
249,1,0,21,0,-21
250,1,1,385,1355,970
251,1,1,446,1857,1411
252,1,0,83,0,-83
253,1,1,353,2770,2417
254,0,0,221,0,-221
255,1,0,46,0,-46
256,0,0,2,0,-2
257,1,1,329,1382,1053
258,0,0,1,0,-1
259,1,0,44,0,-44
260,0,0,44,0,-44
261,1,0,36,0,-36
262,1,1,483,1763,1280
263,0,0,61,0,-61
264,0,0,3,0,-3
265,1,0,28,0,-28
266,1,1,362,1408,1046
267,1,0,25,0,-25
268,1,1,22,1246,1224
269,0,0,17,0,-17
270,1,1,193,1607,1414
271,0,0,142,0,-142
272,1,1,1244,1619,375
273,1,1,1975,1258,-717
274,1,1,177,1321,1144
275,1,1,2140,2070,-70
276,1,1,765,1420,655
277,0,0,158,0,-158
278,0,0,2,0,-2
279,0,0,97,0,-97
280,1,1,908,1316,408
281,0,0,13,0,-13
282,0,0,70,0,-70
283,0,0,37,0,-37
284,1,0,0,0,0
285,1,0,12,0,-12
286,0,0,55,0,-55
287,1,1,727,1968,1241
288,1,0,10,0,-10
289,1,0,77,0,-77
290,0,0,53,0,-53
291,1,1,57,2254,2197
292,1,1,950,1709,759
293,1,0,9,0,-9
294,0,0,104,0,-104
295,1,0,28,0,-28
296,0,0,15,0,-15
297,1,1,997,1655,658
298,0,0,17,0,-17
299,1,1,125,2337,2212
300,0,0,16,0,-16
301,0,0,96,0,-96
302,0,0,106,0,-106
303,1,0,100,0,-100
304,1,1,217,1488,1271
305,1,0,29,0,-29
306,1,1,800,1548,748
307,1,0,15,0,-15
308,1,0,94,0,-94
309,1,1,575,1255,680
310,1,0,181,0,-181
311,0,0,21,0,-21
312,0,0,23,0,-23
313,1,0,7,0,-7
314,0,0,36,0,-36
315,0,0,3,0,-3
316,1,1,449,1224,775
317,1,1,344,1356,1012
318,0,0,41,0,-41
319,0,0,71,0,-71
320,0,0,73,0,-73
321,1,1,89,1292,1203
322,1,1,65,1693,1628
323,1,0,38,0,-38
324,0,0,10,0,-10
325,1,1,197,1249,1052
326,1,0,54,0,-54
327,1,1,35,1293,1258
328,1,1,284,1815,1531
329,1,0,55,0,-55
330,1,0,82,0,-82
331,0,0,4,0,-4
332,1,1,750,2001,1251
333,1,1,848,1266,418
334,1,1,846,1665,819
335,1,0,60,0,-60
336,1,0,66,0,-66
337,0,0,35,0,-35
338,1,1,42,1224,1182
339,0,0,75,0,-75
340,1,0,82,0,-82
341,0,0,34,0,-34
342,1,0,23,0,-23
343,0,0,162,0,-162
344,0,0,17,0,-17
345,0,0,105,0,-105
346,0,0,10,0,-10
347,1,0,132,0,-132
348,1,0,47,0,-47
349,0,0,19,0,-19
350,1,1,686,1610,924
351,1,1,40,1878,1838
352,0,0,41,0,-41
353,0,0,116,0,-116
354,1,0,13,0,-13
355,1,1,101,1837,1736
356,1,0,21,0,-21
357,1,0,14,0,-14
358,0,0,50,0,-50
359,1,0,3,0,-3
360,0,0,19,0,-19
361,0,0,32,0,-32
362,0,0,39,0,-39
363,1,1,459,1888,1429
364,1,1,547,1451,904
365,1,0,21,0,-21
366,1,0,97,0,-97
367,0,0,67,0,-67
368,0,0,51,0,-51
369,1,1,185,2812,2627
370,1,1,849,1981,1132
371,0,0,7,0,-7
372,1,0,33,0,-33
373,1,1,1064,1311,247
374,1,0,46,0,-46
375,1,0,19,0,-19
376,0,0,182,0,-182
377,1,1,103,1200,1097
378,1,0,61,0,-61
379,0,0,32,0,-32
380,1,0,9,0,-9
381,1,0,9,0,-9
382,0,0,36,0,-36
383,1,1,351,1280,929
384,0,0,22,0,-22
385,0,0,54,0,-54
386,1,0,7,0,-7
387,1,0,102,0,-102
388,0,0,172,0,-172
389,0,0,33,0,-33
390,1,1,485,1327,842
391,1,1,391,1382,991
392,1,1,942,2360,1418
393,1,0,9,0,-9
394,1,0,6,0,-6
395,1,0,28,0,-28
396,0,0,4,0,-4
397,1,0,93,0,-93
398,1,0,4,0,-4
399,1,1,295,1305,1010
400,0,0,112,0,-112
401,1,1,449,1468,1019
402,1,1,2453,1459,-994
403,1,0,34,0,-34
404,1,1,588,1205,617
405,0,0,22,0,-22
406,1,1,2348,1466,-882
407,1,0,28,0,-28
408,1,1,105,2050,1945
409,1,1,791,1425,634
410,1,0,46,0,-46
411,0,0,31,0,-31
412,0,0,18,0,-18
413,0,0,57,0,-57
414,1,1,514,1220,706
415,0,0,1,0,-1
416,1,0,64,0,-64
417,0,0,58,0,-58
418,1,0,85,0,-85
419,1,1,947,1892,945
420,1,0,1,0,-1
421,0,0,37,0,-37
422,0,0,37,0,-37
423,1,1,640,1504,864
424,1,1,142,1466,1324
425,1,1,275,1707,1432
426,1,0,47,0,-47
427,0,0,58,0,-58
428,0,0,15,0,-15
429,1,1,631,1353,722
430,0,0,6,0,-6
431,0,0,92,0,-92
432,0,0,3,0,-3
433,1,1,991,1490,499
434,1,0,41,0,-41
435,0,0,60,0,-60
436,1,0,110,0,-110
437,0,0,139,0,-139
438,1,1,27,1345,1318
439,1,1,77,1364,1287
440,1,1,660,1337,677
441,1,0,16,0,-16
442,1,0,22,0,-22
443,1,0,88,0,-88
444,1,1,2315,1365,-950
445,1,1,175,2537,2362
446,1,1,653,1604,951
447,0,0,2,0,-2
448,1,1,104,2963,2859
449,1,1,593,3760,3167
450,0,0,57,0,-57
451,0,0,13,0,-13
452,1,0,166,0,-166
453,1,0,36,0,-36
454,1,0,77,0,-77
455,1,1,166,9742,9576
456,1,0,144,0,-144
457,1,0,59,0,-59
458,1,1,209,1531,1322
459,1,0,26,0,-26
460,1,0,5,0,-5
461,1,0,20,0,-20
462,0,0,117,0,-117
463,1,0,80,0,-80
464,1,1,222,1857,1635
465,0,0,18,0,-18
466,1,0,12,0,-12
467,1,0,17,0,-17
468,0,0,129,0,-129
469,1,0,46,0,-46
470,1,1,455,1952,1497
471,1,1,72,1268,1196
472,0,0,14,0,-14
473,0,0,42,0,-42
474,1,1,583,1414,831
475,0,0,155,0,-155
476,1,1,703,1293,590
477,0,0,45,0,-45
478,0,0,147,0,-147
479,0,0,127,0,-127
480,1,1,774,1340,566
481,1,1,781,1255,474
482,0,0,94,0,-94
483,0,0,0,0,0
484,1,0,144,0,-144
485,1,0,72,0,-72
486,1,1,471,1236,765
487,0,0,0,0,0
488,1,1,555,1378,823
489,1,1,342,1661,1319
490,0,0,49,0,-49
491,1,1,914,1251,337
492,1,0,24,0,-24
493,1,0,104,0,-104
494,1,0,123,0,-123
495,1,0,70,0,-70
496,1,1,419,1401,982
497,0,0,4,0,-4
498,0,0,154,0,-154
499,1,1,201,1353,1152
500,1,1,460,1346,886
501,0,0,91,0,-91
502,0,0,17,0,-17
503,1,1,281,1448,1167
504,1,0,73,0,-73
505,0,0,18,0,-18
506,1,0,130,0,-130
507,0,0,6,0,-6
508,0,0,59,0,-59
509,1,1,566,3078,2512
510,1,1,465,1527,1062
511,1,1,1169,1356,187
512,1,1,793,1445,652
513,1,1,175,1419,1244
514,1,0,57,0,-57
515,0,0,2,0,-2
516,1,0,45,0,-45
517,0,0,8,0,-8
518,1,1,529,1298,769
519,1,0,57,0,-57
520,1,1,1758,1323,-435
521,1,0,168,0,-168
522,0,0,11,0,-11
523,1,1,1495,1360,-135
524,1,1,1325,1258,-67
525,0,0,72,0,-72
526,1,1,71,1543,1472
527,1,0,50,0,-50
528,1,1,62,1498,1436
529,1,0,34,0,-34
530,1,1,92,1379,1287
531,1,1,1562,1387,-175
532,1,0,9,0,-9
533,1,1,313,1286,973
534,1,0,8,0,-8
535,1,0,5,0,-5
536,1,0,58,0,-58
537,1,0,87,0,-87
538,0,0,12,0,-12
539,0,0,59,0,-59
540,1,0,75,0,-75
541,0,0,6,0,-6
542,0,0,38,0,-38
543,1,1,818,1619,801
544,1,0,125,0,-125
545,0,0,17,0,-17
546,0,0,14,0,-14
547,0,0,68,0,-68
548,0,0,76,0,-76
549,1,1,1259,1321,62
550,1,1,915,1712,797
551,0,0,226,0,-226
552,0,0,74,0,-74
553,0,0,118,0,-118
554,0,0,16,0,-16
555,0,0,6,0,-6
556,0,0,15,0,-15
557,1,1,294,1444,1150
558,1,1,755,1291,536
559,0,0,20,0,-20
560,1,0,26,0,-26
561,0,0,11,0,-11
562,1,1,551,1631,1080
563,1,1,85,2076,1991
564,0,0,0,0,0
565,1,0,84,0,-84
566,1,0,59,0,-59
567,1,0,11,0,-11
568,1,0,75,0,-75
569,1,0,141,0,-141
570,0,0,19,0,-19
571,1,1,712,1236,524
572,0,0,1,0,-1
573,0,0,24,0,-24
574,1,0,44,0,-44
575,0,0,5,0,-5
576,0,0,100,0,-100
577,0,0,153,0,-153
578,0,0,49,0,-49
579,1,1,339,1214,875
580,0,0,5,0,-5
581,0,0,18,0,-18
582,0,0,87,0,-87
583,1,1,710,1285,575
584,0,0,16,0,-16
585,1,1,388,1391,1003
586,1,0,33,0,-33
587,1,1,280,1387,1107
588,0,0,16,0,-16
589,0,0,40,0,-40
590,0,0,106,0,-106
591,1,0,40,0,-40
592,1,0,5,0,-5
593,1,1,85,1531,1446
594,1,1,754,1865,1111
595,1,1,620,1825,1205
596,1,0,119,0,-119
597,1,0,36,0,-36
598,1,0,24,0,-24
599,1,0,82,0,-82
600,0,0,45,0,-45
601,0,0,7,0,-7
602,0,0,30,0,-30
603,1,0,2,0,-2
604,0,0,1,0,-1
605,0,0,55,0,-55
606,1,1,344,1239,895
607,1,0,35,0,-35
608,1,1,508,1870,1362
609,1,0,126,0,-126
610,1,1,178,1861,1683
611,1,0,1,0,-1
612,1,1,1135,1231,96
613,0,0,31,0,-31
614,0,0,2,0,-2
615,0,0,87,0,-87
616,1,1,367,1527,1160
617,1,0,32,0,-32
618,1,1,17,2277,2260
619,1,1,324,1330,1006
620,1,1,873,1662,789
621,1,0,31,0,-31
622,0,0,21,0,-21
623,0,0,15,0,-15
624,0,0,16,0,-16
625,1,0,36,0,-36
626,1,0,80,0,-80
627,1,0,27,0,-27
628,1,0,27,0,-27
629,1,0,94,0,-94
630,1,0,25,0,-25
631,0,0,6,0,-6
632,0,0,40,0,-40
633,1,1,547,1357,810
634,1,1,97,1205,1108
635,1,1,454,1253,799
636,0,0,25,0,-25
637,1,0,66,0,-66
638,1,1,1581,1804,223
639,1,0,4,0,-4
640,0,0,52,0,-52
641,1,0,64,0,-64
642,1,0,15,0,-15
643,1,1,536,1918,1382
644,0,0,5,0,-5
645,1,1,1021,1829,808
646,1,1,35,1229,1194
647,1,1,1305,1638,333
648,1,1,280,2295,2015
649,0,0,73,0,-73
650,1,0,9,0,-9
651,0,0,10,0,-10
652,0,0,79,0,-79
653,1,1,459,1244,785
654,0,0,28,0,-28
655,0,0,69,0,-69
656,1,1,273,1702,1429
657,1,1,177,1588,1411
658,0,0,84,0,-84
659,1,0,50,0,-50
660,0,0,70,0,-70
661,0,0,37,0,-37
662,1,0,42,0,-42
663,0,0,74,0,-74
664,0,0,20,0,-20
665,1,1,482,1370,888
666,1,0,102,0,-102
667,1,1,845,1628,783
668,1,0,13,0,-13
669,1,0,76,0,-76
670,0,0,52,0,-52
671,1,1,1147,2523,1376
672,1,1,232,1291,1059
673,0,0,5,0,-5
674,1,0,59,0,-59
675,0,0,23,0,-23
676,1,1,115,1682,1567
677,1,0,41,0,-41
678,1,1,170,1516,1346
679,0,0,62,0,-62
680,1,1,54,1378,1324
681,0,0,115,0,-115
682,1,1,870,1286,416
683,1,1,967,1231,264
684,1,0,28,0,-28
685,0,0,8,0,-8
686,1,0,34,0,-34
687,0,0,25,0,-25
688,1,1,60,1226,1166
689,0,0,19,0,-19
690,1,1,1227,1207,-20
691,0,0,24,0,-24
692,1,1,68,2858,2790
693,0,0,8,0,-8
694,0,0,12,0,-12
695,0,0,4,0,-4
696,1,0,1,0,-1
697,0,0,4,0,-4
698,0,0,3,0,-3
699,1,1,369,1583,1214
700,1,0,62,0,-62
701,1,0,40,0,-40
702,0,0,58,0,-58
703,1,1,1131,1213,82
704,0,0,35,0,-35
705,1,0,20,0,-20
706,1,1,1079,1344,265
707,1,1,632,1406,774
708,1,1,218,1957,1739
709,1,0,140,0,-140
710,0,0,1,0,-1
711,1,0,210,0,-210
712,0,0,37,0,-37
713,0,0,44,0,-44
714,1,1,305,3387,3082
715,0,0,146,0,-146
716,0,0,51,0,-51
717,1,0,2,0,-2
718,1,0,70,0,-70
719,0,0,45,0,-45
720,0,0,204,0,-204
721,0,0,33,0,-33
722,1,0,5,0,-5
723,1,1,1438,1704,266
724,1,1,219,1388,1169
725,0,0,19,0,-19
726,0,0,61,0,-61
727,1,0,38,0,-38
728,1,1,724,1328,604
729,1,1,1559,1223,-336
730,1,1,63,2070,2007
731,1,0,24,0,-24
732,1,1,443,1840,1397
733,0,0,12,0,-12
734,1,0,88,0,-88
735,0,0,71,0,-71
736,1,0,75,0,-75
737,0,0,15,0,-15
738,1,0,20,0,-20
739,0,0,129,0,-129
740,1,0,106,0,-106
741,1,0,55,0,-55
742,1,0,107,0,-107
743,1,0,129,0,-129
744,1,1,563,3421,2858
745,1,1,877,1446,569
746,1,0,23,0,-23
747,1,0,259,0,-259
748,1,1,1713,1473,-240
749,1,1,652,1592,940
750,1,1,464,1269,805
751,1,1,53,1323,1270
752,1,0,54,0,-54
753,0,0,70,0,-70
754,1,1,1413,1440,27
755,1,1,60,2278,2218
756,0,0,23,0,-23
757,0,0,7,0,-7
758,0,0,38,0,-38
759,0,0,89,0,-89
760,1,1,1801,1719,-82
761,1,1,53,1467,1414
762,0,0,37,0,-37
763,1,1,403,1520,1117
764,1,1,386,1415,1029
765,1,0,114,0,-114
766,1,1,738,2318,1580
767,1,0,22,0,-22
768,1,0,53,0,-53
769,0,0,4,0,-4
770,0,0,56,0,-56
771,1,1,108,1200,1092
772,1,1,1297,1308,11
773,1,1,236,1508,1272
774,1,0,116,0,-116
775,1,0,147,0,-147
776,1,0,25,0,-25
777,1,1,139,1222,1083
778,0,0,11,0,-11
779,1,1,557,1229,672
780,1,1,512,1270,758
781,1,1,458,1987,1529
782,1,0,12,0,-12
783,1,0,56,0,-56
784,0,0,12,0,-12
785,1,0,5,0,-5
786,0,0,35,0,-35
787,0,0,15,0,-15
788,1,0,87,0,-87
789,0,0,242,0,-242
790,0,0,115,0,-115
791,1,1,405,1265,860
792,1,0,12,0,-12
793,1,1,228,1352,1124
794,1,1,218,2544,2326
795,1,0,11,0,-11
796,1,1,162,1319,1157
797,1,0,26,0,-26
798,0,0,5,0,-5
799,1,1,290,1296,1006
800,1,1,808,1749,941
801,0,0,25,0,-25
802,0,0,43,0,-43
803,1,0,66,0,-66
804,1,0,21,0,-21
805,1,1,2164,1211,-953
806,1,1,856,1803,947
807,1,1,552,1484,932
808,0,0,20,0,-20
809,1,1,1136,2687,1551
810,1,0,66,0,-66
811,1,1,885,1884,999
812,1,0,27,0,-27
813,1,0,6,0,-6
814,1,0,56,0,-56
815,1,0,100,0,-100
816,1,0,0,0,0
817,1,1,337,1361,1024
818,0,0,24,0,-24
819,0,0,68,0,-68
820,0,0,222,0,-222
821,1,1,58,1334,1276
822,1,0,131,0,-131
823,1,1,144,1237,1093
824,1,1,415,1246,831
825,1,0,29,0,-29
826,0,0,13,0,-13
827,0,0,176,0,-176
828,1,1,542,1310,768
829,1,1,249,1440,1191
830,0,0,19,0,-19
831,0,0,21,0,-21
832,1,0,13,0,-13
833,1,0,92,0,-92
834,1,1,957,1583,626
835,1,1,500,1213,713
836,0,0,62,0,-62
837,1,0,16,0,-16
838,0,0,23,0,-23
839,1,0,15,0,-15
840,1,0,10,0,-10
841,0,0,30,0,-30
842,0,0,61,0,-61
843,0,0,15,0,-15
844,1,1,525,1796,1271
845,1,1,813,1243,430
846,1,1,216,1273,1057
847,1,0,120,0,-120
848,0,0,65,0,-65
849,0,0,0,0,0
850,1,0,16,0,-16
851,1,1,335,1403,1068
852,0,0,220,0,-220
853,1,0,6,0,-6
854,0,0,8,0,-8
855,0,0,3,0,-3
856,0,0,55,0,-55
857,0,0,75,0,-75
858,0,0,165,0,-165
859,1,1,301,2995,2694
860,0,0,52,0,-52
861,1,0,41,0,-41
862,0,0,29,0,-29
863,1,1,59,1292,1233
864,0,0,21,0,-21
865,1,1,524,1340,816
866,0,0,50,0,-50
867,0,0,22,0,-22
868,1,1,1008,1314,306
869,1,0,125,0,-125
870,1,1,942,1286,344
871,1,0,84,0,-84
872,0,0,46,0,-46
873,0,0,68,0,-68
874,1,0,85,0,-85
875,1,1,1726,1874,148
876,1,1,188,1381,1193
877,1,1,1224,1333,109
878,1,0,72,0,-72
879,0,0,10,0,-10
880,1,1,589,1945,1356
881,1,0,10,0,-10
882,1,1,43,1439,1396
883,1,1,72,2019,1947
884,1,1,972,1215,243
885,1,1,102,1213,1111
886,0,0,13,0,-13
887,0,0,49,0,-49
888,1,0,10,0,-10
889,1,1,332,1356,1024
890,1,1,250,1471,1221
891,0,0,2,0,-2
892,1,1,458,1382,924
893,0,0,5,0,-5
894,0,0,8,0,-8
895,1,0,74,0,-74
896,0,0,0,0,0
897,1,0,2,0,-2
898,1,0,145,0,-145
899,0,0,6,0,-6
900,0,0,63,0,-63
901,1,1,470,1344,874
902,1,0,41,0,-41
903,1,1,156,1323,1167
904,0,0,48,0,-48
905,1,1,69,1251,1182
906,0,0,23,0,-23
907,1,1,59,2197,2138
908,0,0,21,0,-21
909,0,0,111,0,-111
910,1,1,195,1269,1074
911,1,1,610,1426,816
912,1,1,52,1235,1183
913,1,1,663,1201,538
914,1,1,1179,2613,1434
915,1,0,73,0,-73
916,1,0,45,0,-45
917,1,1,189,2251,2062
918,1,1,271,1341,1070
919,0,0,21,0,-21
920,1,0,10,0,-10
921,1,0,84,0,-84
922,1,0,31,0,-31
923,1,0,39,0,-39
924,1,0,13,0,-13
925,1,1,165,1317,1152
926,1,1,97,1528,1431
927,0,0,24,0,-24
928,1,1,202,2465,2263
929,1,0,1,0,-1
930,1,0,9,0,-9
931,0,0,41,0,-41
932,1,0,16,0,-16
933,0,0,164,0,-164
934,1,1,155,1456,1301
935,0,0,40,0,-40
936,1,1,1173,2170,997
937,1,1,976,1358,382
938,1,0,20,0,-20
939,1,1,1685,1525,-160
940,0,0,11,0,-11
941,1,1,327,1253,926
942,1,1,504,1340,836
943,0,0,72,0,-72
944,1,1,841,1785,944
945,0,0,12,0,-12
946,0,0,54,0,-54
947,0,0,20,0,-20
948,0,0,5,0,-5
949,0,0,29,0,-29
950,1,0,39,0,-39
951,1,1,176,1479,1303
952,1,0,33,0,-33
953,1,1,145,1347,1202
954,0,0,13,0,-13
955,0,0,74,0,-74
956,1,1,854,1337,483
957,1,0,5,0,-5
958,1,0,107,0,-107
959,1,0,35,0,-35
960,1,0,143,0,-143
961,1,1,845,1249,404
962,0,0,72,0,-72
963,0,0,39,0,-39
964,1,0,2,0,-2
965,1,1,103,1841,1738
966,1,1,440,1250,810
967,0,0,22,0,-22
968,0,0,5,0,-5
969,1,1,745,1213,468
970,0,0,17,0,-17
971,1,0,97,0,-97
972,0,0,26,0,-26
973,1,0,30,0,-30
974,1,0,23,0,-23
975,1,0,15,0,-15
976,0,0,121,0,-121
977,1,0,7,0,-7
978,1,1,1471,1321,-150
979,1,0,87,0,-87
980,0,0,16,0,-16
981,0,0,17,0,-17
982,0,0,98,0,-98
983,1,0,180,0,-180
984,0,0,36,0,-36
985,1,0,9,0,-9
986,0,0,1,0,-1
987,1,1,268,1462,1194
988,0,0,15,0,-15
989,1,1,165,1473,1308
990,0,0,1,0,-1
991,1,0,3,0,-3
992,0,0,154,0,-154
993,1,0,81,0,-81
994,1,1,281,1212,931
995,1,1,223,1233,1010
996,0,0,44,0,-44
997,1,0,20,0,-20
998,1,0,265,0,-265
999,1,0,38,0,-38
1000,1,1,196,1330,1134
1001,1,1,72,1490,1418
1002,0,0,61,0,-61
1003,0,0,3,0,-3
1004,0,0,6,0,-6
1005,0,0,30,0,-30
1006,1,0,60,0,-60
1007,0,0,26,0,-26
1008,1,0,35,0,-35
1009,0,0,11,0,-11
1010,1,1,146,1300,1154
1011,1,1,934,1295,361
1012,0,0,88,0,-88
1013,1,1,429,1250,821
1014,0,0,64,0,-64
1015,1,1,110,1597,1487
1016,0,0,2,0,-2
1017,1,1,770,1252,482
1018,1,0,33,0,-33
1019,1,1,16,1256,1240
1020,0,0,1,0,-1
1021,1,0,48,0,-48
1022,0,0,39,0,-39
1023,1,1,132,1460,1328
1024,1,1,1396,1610,214
1025,1,1,265,1240,975
1026,0,0,66,0,-66
1027,0,0,34,0,-34
1028,1,0,0,0,0
1029,1,0,23,0,-23
1030,1,1,971,1274,303
1031,1,1,274,1944,1670
1032,1,1,339,1651,1312
1033,1,0,9,0,-9
1034,0,0,36,0,-36
1035,0,0,2,0,-2
1036,1,1,427,2218,1791
1037,0,0,256,0,-256
1038,0,0,150,0,-150
1039,1,0,35,0,-35
1040,1,1,8,1334,1326
1041,1,1,70,1244,1174
1042,0,0,16,0,-16
1043,1,1,215,1228,1013
1044,1,1,153,1330,1177
1045,0,0,58,0,-58
1046,1,1,106,1287,1181
1047,1,0,8,0,-8
1048,1,1,1265,1325,60
1049,0,0,1,0,-1
1050,1,1,937,1567,630
1051,1,0,16,0,-16
1052,0,0,15,0,-15
1053,0,0,50,0,-50
1054,1,1,132,1245,1113
1055,0,0,47,0,-47
1056,0,0,48,0,-48
1057,1,1,161,2230,2069
1058,1,0,33,0,-33
1059,0,0,66,0,-66
1060,1,0,90,0,-90
1061,1,1,524,1411,887
1062,1,1,134,1527,1393
1063,0,0,8,0,-8
1064,1,0,53,0,-53
1065,0,0,87,0,-87
1066,1,0,5,0,-5
1067,1,1,60,1503,1443
1068,1,0,8,0,-8
1069,1,0,71,0,-71
1070,0,0,24,0,-24
1071,1,1,43,2571,2528
1072,1,0,60,0,-60
1073,0,0,7,0,-7
1074,1,1,142,1201,1059
1075,0,0,221,0,-221
1076,0,0,59,0,-59
1077,1,0,36,0,-36
1078,1,0,57,0,-57
1079,1,1,444,1306,862
1080,1,0,5,0,-5
1081,1,0,72,0,-72
1082,1,1,128,1427,1299
1083,1,0,20,0,-20
1084,0,0,29,0,-29
1085,0,0,25,0,-25
1086,0,0,21,0,-21
1087,1,1,55,1267,1212
1088,0,0,26,0,-26
1089,0,0,95,0,-95
1090,1,1,536,1286,750
1091,1,0,67,0,-67
1092,1,1,496,1369,873
1093,1,0,40,0,-40
1094,1,1,900,1225,325
1095,1,1,445,2153,1708
1096,0,0,10,0,-10
1097,0,0,121,0,-121
1098,0,0,45,0,-45
1099,1,0,12,0,-12
1100,1,1,526,1413,887
1101,1,1,328,1232,904
1102,0,0,29,0,-29
1103,1,1,1643,1403,-240
1104,0,0,19,0,-19
1105,1,1,328,1400,1072
1106,1,1,62,1421,1359
1107,1,1,288,1676,1388
1108,1,1,1225,1240,15
1109,1,0,2,0,-2
1110,1,1,50,1271,1221
1111,0,0,75,0,-75
1112,0,0,5,0,-5
1113,1,0,8,0,-8
1114,0,0,24,0,-24
1115,1,1,461,1318,857
1116,0,0,96,0,-96
1117,1,0,246,0,-246
1118,1,1,175,1547,1372
1119,1,0,55,0,-55
1120,1,1,1097,1493,396
1121,1,0,29,0,-29
1122,1,1,268,1357,1089
1123,0,0,8,0,-8
1124,0,0,32,0,-32
1125,1,1,321,1302,981
1126,1,1,58,1352,1294
1127,0,0,50,0,-50
1128,1,1,243,1320,1077
1129,0,0,9,0,-9
1130,1,0,7,0,-7
1131,1,1,188,1400,1212
1132,1,0,11,0,-11
1133,1,0,18,0,-18
1134,1,1,530,1820,1290
1135,0,0,13,0,-13
1136,0,0,101,0,-101
1137,0,0,102,0,-102
1138,0,0,58,0,-58
1139,1,0,56,0,-56
1140,1,1,1368,1399,31
1141,0,0,20,0,-20
1142,1,1,23,1367,1344
1143,0,0,113,0,-113
1144,0,0,8,0,-8
1145,1,1,379,1293,914
1146,1,0,6,0,-6
1147,0,0,217,0,-217
1148,1,1,181,1323,1142
1149,1,1,1075,1418,343
1150,1,1,330,2176,1846
1151,0,0,2,0,-2
1152,0,0,118,0,-118
1153,0,0,10,0,-10
1154,1,1,573,1331,758
1155,0,0,27,0,-27
1156,0,0,0,0,0
1157,1,0,140,0,-140
1158,1,1,82,1895,1813
1159,0,0,22,0,-22
1160,0,0,33,0,-33
1161,1,0,163,0,-163
1162,0,0,91,0,-91
1163,1,1,788,1218,430
1164,1,0,23,0,-23
1165,0,0,97,0,-97
1166,0,0,19,0,-19
1167,1,1,1042,1438,396
1168,0,0,87,0,-87
1169,1,1,308,1230,922
1170,1,1,896,1208,312
1171,1,0,14,0,-14
1172,0,0,160,0,-160
1173,1,0,69,0,-69
1174,0,0,35,0,-35
1175,0,0,18,0,-18
1176,0,0,92,0,-92
1177,1,1,179,1368,1189
1178,1,1,408,1536,1128
1179,1,1,1742,1411,-331
1180,0,0,16,0,-16
1181,1,0,19,0,-19
1182,1,1,270,1358,1088
1183,1,1,1370,1736,366
1184,1,0,71,0,-71
1185,0,0,35,0,-35
1186,1,0,11,0,-11
1187,1,0,13,0,-13
1188,0,0,45,0,-45
1189,0,0,44,0,-44
1190,1,1,617,1320,703
1191,1,0,9,0,-9
1192,0,0,29,0,-29
1193,1,0,69,0,-69
1194,1,1,718,1707,989
1195,0,0,98,0,-98
1196,1,1,604,1394,790
1197,1,1,235,1338,1103
1198,0,0,27,0,-27
1199,1,1,556,1203,647
1200,1,1,229,2324,2095
1201,0,0,6,0,-6
1202,1,0,24,0,-24
1203,0,0,55,0,-55
1204,1,1,131,1397,1266
1205,1,1,494,1814,1320
1206,0,0,43,0,-43
1207,1,0,18,0,-18
1208,0,0,47,0,-47
1209,1,0,57,0,-57
1210,1,0,0,0,0
1211,0,0,7,0,-7
1212,0,0,1,0,-1
1213,1,0,69,0,-69
1214,1,0,34,0,-34
1215,1,1,285,1472,1187
1216,0,0,178,0,-178
1217,1,1,1310,1226,-84
1218,0,0,169,0,-169
1219,0,0,38,0,-38
1220,1,1,510,2146,1636
1221,0,0,50,0,-50
1222,0,0,47,0,-47
1223,0,0,19,0,-19
1224,1,1,251,1459,1208
1225,1,1,672,1241,569
1226,1,1,1361,1234,-127
1227,1,1,164,1268,1104
1228,0,0,3,0,-3
1229,1,0,55,0,-55
1230,0,0,37,0,-37
1231,1,0,91,0,-91
1232,0,0,43,0,-43
1233,1,1,319,1270,951
1234,1,0,52,0,-52
1235,1,1,1023,1907,884
1236,0,0,121,0,-121
1237,0,0,25,0,-25
1238,0,0,2,0,-2
1239,0,0,78,0,-78
1240,1,0,13,0,-13
1241,1,0,82,0,-82
1242,1,0,21,0,-21
1243,1,1,120,2044,1924
1244,0,0,209,0,-209
1245,1,0,63,0,-63
1246,1,1,257,2669,2412
1247,0,0,46,0,-46
1248,1,1,1354,1258,-96
1249,1,0,64,0,-64
1250,1,0,4,0,-4
1251,1,0,3,0,-3
1252,0,0,10,0,-10
1253,1,0,109,0,-109
1254,0,0,40,0,-40
1255,0,0,3,0,-3
1256,0,0,3,0,-3
1257,1,1,565,1409,844
1258,1,0,42,0,-42
1259,1,1,809,1226,417
1260,1,1,240,1626,1386
1261,1,0,32,0,-32
1262,1,0,7,0,-7
1263,0,0,24,0,-24
1264,1,1,955,1548,593
1265,1,1,780,1787,1007
1266,1,1,228,1279,1051
1267,1,0,44,0,-44
1268,1,0,25,0,-25
1269,1,0,61,0,-61
1270,1,1,1236,1908,672
1271,1,1,229,1308,1079
1272,1,0,31,0,-31
1273,0,0,26,0,-26
1274,0,0,10,0,-10
1275,0,0,68,0,-68
1276,1,0,9,0,-9
1277,1,1,208,3193,2985
1278,0,0,20,0,-20
1279,1,1,658,1755,1097
1280,0,0,60,0,-60
1281,0,0,29,0,-29
1282,1,0,72,0,-72
1283,0,0,66,0,-66
1284,1,0,1,0,-1
1285,0,0,71,0,-71
1286,0,0,11,0,-11
1287,0,0,4,0,-4
1288,1,1,128,1383,1255
1289,0,0,11,0,-11
1290,1,1,109,1299,1190
1291,0,0,122,0,-122
1292,1,1,519,1466,947
1293,1,0,30,0,-30
1294,1,0,34,0,-34
1295,0,0,139,0,-139
1296,1,1,426,1912,1486
1297,0,0,41,0,-41
1298,0,0,150,0,-150
1299,1,1,56,1210,1154
1300,1,1,302,1393,1091
1301,0,0,109,0,-109
1302,0,0,10,0,-10
1303,0,0,78,0,-78
1304,1,1,946,1509,563
1305,0,0,173,0,-173
1306,1,0,290,0,-290
1307,1,0,3,0,-3
1308,1,1,237,1719,1482
1309,1,1,1188,1803,615
1310,1,0,80,0,-80
1311,0,0,43,0,-43
1312,1,0,11,0,-11
1313,0,0,197,0,-197
1314,1,1,68,1703,1635
1315,0,0,23,0,-23
1316,1,0,2,0,-2
1317,1,0,25,0,-25
1318,0,0,33,0,-33
1319,0,0,61,0,-61
1320,1,1,1439,2163,724
1321,1,1,795,1477,682
1322,1,0,112,0,-112
1323,1,1,95,1554,1459
1324,1,0,28,0,-28
1325,1,1,338,1982,1644
1326,0,0,137,0,-137
1327,1,0,54,0,-54
1328,1,1,638,1398,760
1329,0,0,32,0,-32
1330,0,0,30,0,-30
1331,1,0,6,0,-6
1332,0,0,20,0,-20
1333,1,1,638,2614,1976
1334,1,0,2,0,-2
1335,1,0,26,0,-26
1336,1,1,99,3082,2983
1337,0,0,51,0,-51
1338,1,0,98,0,-98
1339,0,0,14,0,-14
1340,1,1,79,1934,1855
1341,0,0,62,0,-62
1342,1,1,1733,1451,-282
1343,1,0,75,0,-75
1344,1,0,103,0,-103
1345,0,0,46,0,-46
1346,0,0,40,0,-40
1347,0,0,71,0,-71
1348,0,0,16,0,-16
1349,0,0,116,0,-116
1350,1,0,103,0,-103
1351,1,0,2,0,-2
1352,1,0,39,0,-39
1353,1,1,655,1523,868
1354,0,0,202,0,-202
1355,0,0,62,0,-62
1356,0,0,102,0,-102
1357,1,1,211,1338,1127
1358,1,1,285,2418,2133
1359,1,0,18,0,-18
1360,1,0,104,0,-104
1361,1,1,453,2796,2343
1362,0,0,220,0,-220
1363,1,1,745,1425,680
1364,0,0,3,0,-3
1365,1,0,8,0,-8
1366,0,0,37,0,-37
1367,1,0,0,0,0
1368,1,0,10,0,-10
1369,1,1,332,3469,3137
1370,1,0,49,0,-49
1371,0,0,4,0,-4
1372,0,0,24,0,-24
1373,0,0,67,0,-67
1374,0,0,32,0,-32
1375,0,0,14,0,-14
1376,0,0,76,0,-76
1377,1,0,7,0,-7
1378,0,0,9,0,-9
1379,1,1,208,1672,1464
1380,0,0,111,0,-111
1381,0,0,46,0,-46
1382,0,0,139,0,-139
1383,1,0,88,0,-88
1384,1,1,1603,1531,-72
1385,1,1,179,1484,1305
1386,1,1,86,1484,1398
1387,1,1,1913,1299,-614
1388,1,0,13,0,-13
1389,0,0,9,0,-9
1390,0,0,35,0,-35
1391,1,1,497,1743,1246
1392,0,0,104,0,-104
1393,0,0,11,0,-11
1394,1,1,71,1552,1481
1395,0,0,41,0,-41
1396,0,0,134,0,-134
1397,1,1,228,1337,1109
1398,0,0,29,0,-29
1399,1,1,1776,2199,423
1400,1,0,68,0,-68
1401,1,1,701,1225,524
1402,0,0,64,0,-64
1403,1,1,140,1354,1214
1404,1,0,27,0,-27
1405,0,0,159,0,-159
1406,1,1,1044,1369,325
1407,1,1,147,1623,1476
1408,0,0,18,0,-18
1409,1,0,76,0,-76
1410,0,0,203,0,-203
1411,1,1,409,1491,1082
1412,1,1,958,1302,344
1413,0,0,2,0,-2
1414,1,1,357,1443,1086
1415,1,1,654,1351,697
1416,0,0,50,0,-50
1417,1,1,629,1953,1324
1418,0,0,46,0,-46
1419,1,1,1921,2223,302
1420,1,1,150,1459,1309
1421,0,0,9,0,-9
1422,0,0,32,0,-32
1423,1,1,98,1818,1720
1424,1,1,65,1554,1489
1425,1,1,1268,1221,-47
1426,0,0,7,0,-7
1427,0,0,40,0,-40
1428,0,0,34,0,-34
1429,1,0,77,0,-77
1430,1,1,475,1439,964
1431,0,0,13,0,-13
1432,0,0,53,0,-53
1433,1,0,235,0,-235
1434,1,1,890,1213,323
1435,1,1,273,2404,2131
1436,0,0,76,0,-76
1437,1,1,41,1314,1273
1438,1,0,0,0,0
1439,1,0,72,0,-72
1440,1,0,34,0,-34
1441,1,0,8,0,-8
1442,1,1,293,1349,1056
1443,1,1,99,3071,2972
1444,1,1,201,1758,1557
1445,0,0,1,0,-1
1446,0,0,61,0,-61
1447,1,1,135,1459,1324
1448,1,0,45,0,-45
1449,0,0,13,0,-13
1450,0,0,201,0,-201
1451,0,0,115,0,-115
1452,1,0,75,0,-75
1453,0,0,10,0,-10
1454,1,0,18,0,-18
1455,1,0,7,0,-7
1456,1,1,286,2199,1913
1457,1,0,2,0,-2
1458,1,1,1008,2459,1451
1459,1,0,43,0,-43
1460,0,0,100,0,-100
1461,0,0,149,0,-149
1462,1,1,46,1365,1319
1463,0,0,80,0,-80
1464,1,0,29,0,-29
1465,1,1,190,1387,1197
1466,1,0,3,0,-3
1467,0,0,24,0,-24
1468,0,0,15,0,-15
1469,1,1,669,1221,552
1470,1,0,150,0,-150
1471,1,1,232,2039,1807
1472,1,1,89,1474,1385
1473,1,0,1,0,-1
1474,1,1,46,1215,1169
1475,0,0,5,0,-5
1476,0,0,3,0,-3
1477,0,0,34,0,-34
1478,1,0,39,0,-39
1479,1,1,783,1491,708
1480,1,1,1073,1451,378
1481,0,0,90,0,-90
1482,1,1,2866,1394,-1472
1483,1,1,203,1501,1298
1484,1,0,4,0,-4
1485,0,0,11,0,-11
1486,1,0,269,0,-269
1487,0,0,0,0,0
1488,1,0,32,0,-32
1489,0,0,57,0,-57
1490,1,0,11,0,-11
1491,0,0,274,0,-274
1492,1,0,36,0,-36
1493,1,1,173,1263,1090
1494,0,0,28,0,-28
1495,1,1,186,1431,1245
1496,1,1,160,1385,1225
1497,0,0,75,0,-75
1498,0,0,197,0,-197
1499,1,1,303,1505,1202
1500,1,0,9,0,-9
1501,1,1,387,1315,928
1502,1,0,43,0,-43
1503,1,1,104,1371,1267
1504,0,0,137,0,-137
1505,0,0,20,0,-20
1506,0,0,46,0,-46
1507,0,0,47,0,-47
1508,1,1,994,1883,889
1509,1,1,405,1859,1454
1510,0,0,107,0,-107
1511,0,0,35,0,-35
1512,1,1,66,1251,1185
1513,0,0,37,0,-37
1514,1,1,494,1942,1448
1515,1,1,100,1309,1209
1516,0,0,47,0,-47
1517,1,1,814,1721,907
1518,0,0,123,0,-123
1519,1,1,128,1684,1556
1520,1,1,742,1503,761
1521,1,1,94,1269,1175
1522,0,0,0,0,0
1523,1,1,667,1704,1037
1524,1,0,3,0,-3
1525,1,0,64,0,-64
1526,1,0,0,0,0
1527,1,0,2,0,-2
1528,0,0,36,0,-36
1529,1,0,176,0,-176
1530,0,0,62,0,-62
1531,1,1,678,1318,640
1532,0,0,40,0,-40
1533,0,0,9,0,-9
1534,1,1,1278,1232,-46
1535,1,1,672,1498,826
1536,0,0,213,0,-213
1537,1,1,647,1338,691
1538,1,0,129,0,-129
1539,1,1,811,1671,860
1540,1,0,126,0,-126
1541,0,0,185,0,-185
1542,0,0,37,0,-37
1543,1,0,58,0,-58
1544,0,0,14,0,-14
1545,0,0,24,0,-24
1546,0,0,156,0,-156
1547,0,0,60,0,-60
1548,1,1,356,1840,1484
1549,1,0,7,0,-7
1550,0,0,33,0,-33
1551,1,0,2,0,-2
1552,1,1,137,1269,1132
1553,1,1,834,1675,841
1554,0,0,81,0,-81
1555,1,1,559,1763,1204
1556,0,0,79,0,-79
1557,1,1,236,1425,1189
1558,1,0,6,0,-6
1559,1,1,211,1643,1432
1560,1,1,236,1512,1276
1561,0,0,54,0,-54
1562,1,0,49,0,-49
1563,1,1,252,1283,1031
1564,1,0,0,0,0
1565,1,1,672,1871,1199
1566,1,0,56,0,-56
1567,1,1,453,1311,858
1568,1,1,159,1204,1045
1569,1,0,12,0,-12
1570,0,0,11,0,-11
1571,0,0,0,0,0
1572,0,0,162,0,-162
1573,0,0,234,0,-234
1574,1,1,199,1299,1100
1575,1,1,93,1913,1820
1576,1,0,70,0,-70
1577,1,0,29,0,-29
1578,1,1,289,1421,1132
1579,1,1,615,1636,1021
1580,1,1,113,1373,1260
1581,0,0,64,0,-64
1582,1,0,6,0,-6
1583,1,0,163,0,-163
1584,0,0,74,0,-74
1585,0,0,7,0,-7
1586,1,1,492,2152,1660
1587,1,1,676,1596,920
1588,0,0,28,0,-28
1589,1,1,97,1884,1787
1590,0,0,46,0,-46
1591,1,0,50,0,-50
1592,0,0,49,0,-49
1593,1,0,13,0,-13
1594,0,0,175,0,-175
1595,1,1,319,1523,1204
1596,1,1,460,1784,1324
1597,0,0,49,0,-49
1598,1,0,5,0,-5
1599,0,0,56,0,-56
1600,1,0,29,0,-29
1601,1,1,1350,1975,625
1602,0,0,77,0,-77
1603,1,0,0,0,0
1604,0,0,60,0,-60
1605,1,1,289,1251,962
1606,1,1,151,1293,1142
1607,0,0,108,0,-108
1608,1,0,24,0,-24
1609,0,0,124,0,-124
1610,1,0,9,0,-9
1611,0,0,67,0,-67
1612,0,0,9,0,-9
1613,1,1,267,1343,1076
1614,0,0,6,0,-6
1615,1,1,34,1242,1208
1616,0,0,209,0,-209
1617,1,1,63,1820,1757
1618,0,0,78,0,-78
1619,1,1,688,1431,743
1620,1,0,66,0,-66
1621,1,1,1401,1923,522
1622,1,0,179,0,-179
1623,1,1,433,1250,817
1624,0,0,23,0,-23
1625,0,0,6,0,-6
1626,1,0,46,0,-46
1627,0,0,17,0,-17
1628,1,0,47,0,-47
1629,0,0,76,0,-76
1630,1,1,118,1456,1338
1631,0,0,12,0,-12
1632,0,0,5,0,-5
1633,0,0,85,0,-85
1634,0,0,35,0,-35
1635,0,0,52,0,-52
1636,0,0,206,0,-206
1637,0,0,47,0,-47
1638,0,0,3,0,-3
1639,0,0,38,0,-38
1640,0,0,16,0,-16
1641,1,1,1037,1372,335
1642,1,1,666,1617,951
1643,1,0,21,0,-21
1644,1,1,988,2239,1251
1645,1,1,2015,1245,-770
1646,1,0,19,0,-19
1647,1,1,297,2066,1769
1648,0,0,10,0,-10
1649,1,1,41,1259,1218
1650,1,1,1005,1321,316
1651,1,1,187,1556,1369
1652,1,0,48,0,-48
1653,0,0,75,0,-75
1654,0,0,87,0,-87
1655,1,1,1483,1218,-265
1656,1,1,465,2064,1599
1657,0,0,11,0,-11
1658,1,1,576,1652,1076
1659,1,1,236,1352,1116
1660,1,1,715,1738,1023
1661,0,0,96,0,-96
1662,1,0,32,0,-32
1663,1,1,175,1459,1284
1664,1,1,277,1576,1299
1665,0,0,39,0,-39
1666,1,1,533,1235,702
1667,0,0,8,0,-8
1668,1,1,131,1215,1084
1669,1,1,1278,1283,5
1670,1,0,1,0,-1
1671,1,1,312,2253,1941
1672,1,1,55,1394,1339
1673,1,1,1245,1558,313
1674,0,0,45,0,-45
1675,0,0,25,0,-25
1676,1,1,252,1351,1099
1677,0,0,24,0,-24
1678,0,0,43,0,-43
1679,0,0,0,0,0
1680,0,0,53,0,-53
1681,0,0,61,0,-61
1682,0,0,94,0,-94
1683,1,1,867,1608,741
1684,1,1,1111,1307,196
1685,0,0,41,0,-41
1686,1,0,19,0,-19
1687,1,1,335,1268,933
1688,1,0,42,0,-42
1689,1,1,485,1400,915
1690,0,0,30,0,-30
1691,1,0,54,0,-54
1692,1,1,327,1823,1496
1693,1,0,132,0,-132
1694,1,1,1352,1339,-13
1695,1,0,11,0,-11
1696,0,0,113,0,-113
1697,0,0,0,0,0
1698,1,0,109,0,-109
1699,0,0,47,0,-47
1700,0,0,20,0,-20
1701,1,0,18,0,-18
1702,1,1,851,1215,364
1703,1,0,52,0,-52
1704,1,0,11,0,-11
1705,1,0,95,0,-95
1706,0,0,5,0,-5
1707,1,1,231,1421,1190
1708,1,1,1087,1257,170
1709,0,0,4,0,-4
1710,0,0,129,0,-129
1711,0,0,30,0,-30
1712,1,1,130,1263,1133
1713,1,1,318,1234,916
1714,1,1,42,1951,1909
1715,1,0,7,0,-7
1716,1,1,21,1293,1272
1717,1,1,904,2197,1293
1718,1,1,243,1280,1037
1719,1,1,579,1652,1073
1720,1,0,21,0,-21
1721,1,1,62,1270,1208
1722,1,1,101,1608,1507
1723,1,1,155,1305,1150
1724,0,0,1,0,-1
1725,1,0,64,0,-64
1726,0,0,5,0,-5
1727,1,1,519,1592,1073
1728,0,0,97,0,-97
1729,1,1,252,3960,3708
1730,1,0,92,0,-92
1731,1,1,237,1710,1473
1732,0,0,6,0,-6
1733,1,1,544,1551,1007
1734,1,0,58,0,-58
1735,1,1,391,1339,948
1736,0,0,53,0,-53
1737,0,0,133,0,-133
1738,1,0,89,0,-89
1739,1,0,1,0,-1
1740,1,0,0,0,0
1741,1,0,133,0,-133
1742,0,0,86,0,-86
1743,1,1,160,1322,1162
1744,1,1,338,1448,1110
1745,1,1,1070,1366,296
1746,1,0,104,0,-104
1747,1,0,47,0,-47
1748,0,0,15,0,-15
1749,0,0,30,0,-30
1750,0,0,57,0,-57
1751,1,1,51,1378,1327
1752,0,0,28,0,-28
1753,1,1,1012,1251,239
1754,0,0,57,0,-57
1755,0,0,30,0,-30
1756,1,0,47,0,-47
1757,0,0,9,0,-9
1758,0,0,19,0,-19
1759,1,1,1119,2074,955
1760,1,0,50,0,-50
1761,1,1,71,1377,1306
1762,1,1,1015,3018,2003
1763,1,1,876,1205,329
1764,0,0,98,0,-98
1765,1,1,93,1872,1779
1766,0,0,36,0,-36
1767,1,1,553,1434,881
1768,0,0,54,0,-54
1769,1,1,309,1885,1576
1770,1,1,112,1480,1368
1771,0,0,18,0,-18
1772,0,0,19,0,-19
1773,1,1,78,1713,1635
1774,0,0,45,0,-45
1775,1,1,1477,1866,389
1776,0,0,9,0,-9
1777,1,1,312,1839,1527
1778,1,1,53,1234,1181
1779,1,0,45,0,-45
1780,0,0,21,0,-21
1781,1,1,49,1629,1580
1782,1,1,370,1275,905
1783,1,1,833,2119,1286
1784,1,0,8,0,-8
1785,1,1,557,2472,1915
1786,0,0,41,0,-41
1787,1,1,98,1208,1110
1788,0,0,18,0,-18
1789,1,0,0,0,0
1790,0,0,63,0,-63
1791,1,1,522,1395,873
1792,1,0,52,0,-52
1793,1,0,3,0,-3
1794,1,0,179,0,-179
1795,0,0,2,0,-2
1796,1,1,188,3369,3181
1797,0,0,78,0,-78
1798,0,0,85,0,-85
1799,1,1,284,1864,1580
1800,1,1,1692,1570,-122
1801,1,1,814,1295,481
1802,0,0,82,0,-82
1803,1,0,173,0,-173
1804,1,1,91,1779,1688
1805,1,0,58,0,-58
1806,1,1,136,1409,1273
1807,0,0,38,0,-38
1808,1,1,112,1200,1088
1809,0,0,45,0,-45
1810,1,0,7,0,-7
1811,1,1,1454,1379,-75
1812,1,0,61,0,-61
1813,0,0,135,0,-135
1814,1,0,67,0,-67
1815,1,0,1,0,-1
1816,0,0,53,0,-53
1817,1,1,1065,1392,327
1818,0,0,67,0,-67
1819,1,0,48,0,-48
1820,0,0,8,0,-8
1821,0,0,33,0,-33
1822,1,1,208,1684,1476
1823,1,1,120,1341,1221
1824,0,0,25,0,-25
1825,0,0,5,0,-5
1826,0,0,10,0,-10
1827,1,1,203,1894,1691
1828,0,0,58,0,-58
1829,0,0,38,0,-38
1830,0,0,101,0,-101
1831,0,0,70,0,-70
1832,1,0,74,0,-74
1833,1,1,842,1283,441
1834,1,0,32,0,-32
1835,0,0,142,0,-142
1836,0,0,18,0,-18
1837,0,0,1,0,-1
1838,1,0,13,0,-13
1839,0,0,23,0,-23
1840,1,1,515,1218,703
1841,1,0,41,0,-41
1842,0,0,62,0,-62
1843,1,1,312,1240,928
1844,0,0,25,0,-25
1845,1,0,216,0,-216
1846,1,1,75,1321,1246
1847,1,1,151,1483,1332
1848,0,0,18,0,-18
1849,0,0,45,0,-45
1850,1,0,11,0,-11
1851,1,0,40,0,-40
1852,1,1,660,1211,551
1853,1,1,352,1435,1083
1854,1,0,82,0,-82
1855,1,0,49,0,-49
1856,1,0,6,0,-6
1857,0,0,85,0,-85
1858,0,0,41,0,-41
1859,0,0,11,0,-11
1860,1,1,528,1507,979
1861,1,0,68,0,-68
1862,0,0,37,0,-37
1863,1,1,670,1347,677
1864,1,0,59,0,-59
1865,0,0,4,0,-4
1866,0,0,101,0,-101
1867,1,1,74,2023,1949
1868,1,0,37,0,-37
1869,1,0,0,0,0
1870,0,0,4,0,-4
1871,1,0,25,0,-25
1872,0,0,127,0,-127
1873,0,0,23,0,-23
1874,0,0,65,0,-65
1875,0,0,5,0,-5
1876,0,0,57,0,-57
1877,0,0,9,0,-9
1878,1,0,27,0,-27
1879,1,0,25,0,-25
1880,1,0,90,0,-90
1881,0,0,27,0,-27
1882,1,1,682,1454,772
1883,0,0,14,0,-14
1884,0,0,6,0,-6
1885,1,0,86,0,-86
1886,0,0,102,0,-102
1887,0,0,35,0,-35
1888,1,1,176,2353,2177
1889,1,0,14,0,-14
1890,0,0,4,0,-4
1891,0,0,16,0,-16
1892,0,0,76,0,-76
1893,1,1,1544,1200,-344
1894,0,0,13,0,-13
1895,0,0,33,0,-33
1896,1,0,6,0,-6
1897,0,0,14,0,-14
1898,1,1,314,1594,1280
1899,1,0,12,0,-12
1900,1,0,40,0,-40
1901,1,0,82,0,-82
1902,1,1,583,2087,1504
1903,0,0,21,0,-21
1904,1,0,64,0,-64
1905,1,1,252,1427,1175
1906,1,0,105,0,-105
1907,1,1,326,1551,1225
1908,1,1,87,1283,1196
1909,0,0,109,0,-109
1910,1,0,71,0,-71
1911,1,1,669,1407,738
1912,0,0,134,0,-134
1913,0,0,4,0,-4
1914,1,1,1741,2956,1215
1915,0,0,53,0,-53
1916,1,1,119,3125,3006
1917,1,1,1344,2101,757
1918,1,1,1624,1638,14
1919,1,1,256,1450,1194
1920,0,0,53,0,-53
1921,1,1,297,2146,1849
1922,1,0,28,0,-28
1923,1,1,563,2300,1737
1924,0,0,45,0,-45
1925,1,1,43,2453,2410
1926,0,0,69,0,-69
1927,0,0,25,0,-25
1928,1,1,453,1387,934
1929,1,0,63,0,-63
1930,0,0,62,0,-62
1931,0,0,41,0,-41
1932,0,0,39,0,-39
1933,0,0,74,0,-74
1934,1,1,376,1262,886
1935,1,0,5,0,-5
1936,0,0,25,0,-25
1937,1,0,199,0,-199
1938,1,0,31,0,-31
1939,1,1,354,1267,913
1940,1,1,2367,1248,-1119
1941,1,1,1147,1505,358
1942,0,0,63,0,-63
1943,1,1,150,1839,1689
1944,1,1,1525,1652,127
1945,1,0,0,0,0
1946,1,0,0,0,0
1947,1,1,359,1706,1347
1948,0,0,104,0,-104
1949,1,1,384,1381,997
1950,0,0,65,0,-65
1951,0,0,57,0,-57
1952,0,0,16,0,-16
1953,1,1,202,1321,1119
1954,0,0,121,0,-121
1955,0,0,87,0,-87
1956,1,1,695,1267,572
1957,1,1,15,1250,1235
1958,1,1,158,1521,1363
1959,1,1,890,1617,727
1960,1,1,369,1506,1137
1961,1,1,682,1528,846
1962,1,0,157,0,-157
1963,1,0,22,0,-22
1964,1,0,3,0,-3
1965,0,0,22,0,-22
1966,1,1,856,1319,463
1967,1,0,60,0,-60
1968,0,0,65,0,-65
1969,1,1,1512,1315,-197
1970,1,1,713,2250,1537
1971,0,0,2,0,-2
1972,0,0,10,0,-10
1973,1,0,45,0,-45
1974,1,0,36,0,-36
1975,0,0,88,0,-88
1976,1,1,1503,1253,-250
1977,1,0,9,0,-9
1978,1,1,1136,1763,627
1979,0,0,156,0,-156
1980,1,1,50,1480,1430
1981,0,0,106,0,-106
1982,0,0,39,0,-39
1983,1,0,224,0,-224
1984,1,0,122,0,-122
1985,0,0,9,0,-9
1986,1,1,446,1651,1205
1987,1,1,368,1681,1313
1988,0,0,58,0,-58
1989,1,1,155,4619,4464
1990,0,0,122,0,-122
1991,1,1,196,1448,1252
1992,0,0,18,0,-18
1993,1,0,21,0,-21
1994,0,0,16,0,-16
1995,1,1,846,1488,642
1996,0,0,55,0,-55
1997,0,0,83,0,-83
1998,0,0,6,0,-6
1999,1,0,35,0,-35
2000,0,0,6,0,-6
2001,1,1,624,1665,1041
2002,1,1,371,2468,2097
2003,1,1,394,1765,1371
2004,0,0,207,0,-207
2005,1,1,42,1361,1319
2006,1,1,861,1268,407
2007,1,0,43,0,-43
2008,0,0,52,0,-52
2009,1,0,10,0,-10
2010,1,0,117,0,-117
2011,0,0,19,0,-19
2012,1,0,0,0,0
2013,1,1,68,1930,1862
2014,0,0,160,0,-160
2015,0,0,66,0,-66
2016,0,0,69,0,-69
2017,1,0,16,0,-16
2018,0,0,109,0,-109
2019,1,1,1001,1315,314
2020,1,1,121,1232,1111
2021,1,0,333,0,-333
2022,0,0,13,0,-13
2023,1,1,224,1298,1074
2024,0,0,47,0,-47
2025,1,0,286,0,-286
2026,1,0,12,0,-12
2027,0,0,10,0,-10
2028,1,1,1137,1870,733
2029,1,1,446,1550,1104
2030,1,1,382,2111,1729
2031,1,1,63,1671,1608
2032,0,0,53,0,-53
2033,0,0,30,0,-30
2034,0,0,14,0,-14
2035,1,1,350,1205,855
2036,1,0,158,0,-158
2037,0,0,76,0,-76
2038,1,0,2,0,-2
2039,1,1,480,1707,1227
2040,0,0,5,0,-5
2041,0,0,20,0,-20
2042,1,1,81,2750,2669
2043,1,1,111,1383,1272
2044,1,1,128,1386,1258
2045,1,0,83,0,-83
2046,1,0,19,0,-19
2047,1,1,39,2411,2372
2048,0,0,7,0,-7
2049,1,1,256,1205,949
2050,1,1,287,1271,984
2051,1,0,18,0,-18
2052,1,0,109,0,-109
2053,1,1,195,1288,1093
2054,1,0,33,0,-33
2055,1,0,14,0,-14
2056,0,0,3,0,-3
2057,1,1,424,1876,1452
2058,1,0,56,0,-56
2059,0,0,17,0,-17
2060,1,1,267,1207,940
2061,0,0,17,0,-17
2062,1,1,256,1951,1695
2063,1,0,13,0,-13
2064,1,0,31,0,-31
2065,1,1,1357,1315,-42
2066,0,0,0,0,0
2067,1,1,272,1269,997
2068,0,0,16,0,-16
2069,0,0,89,0,-89
2070,1,1,1221,1943,722
2071,0,0,53,0,-53
2072,0,0,5,0,-5
2073,1,1,434,1376,942
2074,0,0,0,0,0
2075,1,0,14,0,-14
2076,0,0,10,0,-10
2077,1,1,188,1220,1032
2078,1,0,149,0,-149
2079,0,0,10,0,-10
2080,0,0,260,0,-260
2081,1,1,1497,1292,-205
2082,0,0,42,0,-42
2083,0,0,53,0,-53
2084,0,0,21,0,-21
2085,0,0,111,0,-111
2086,0,0,50,0,-50
2087,1,1,311,1400,1089
2088,1,1,761,1210,449
2089,0,0,109,0,-109
2090,1,0,33,0,-33
2091,0,0,4,0,-4
2092,0,0,34,0,-34
2093,1,0,102,0,-102
2094,0,0,47,0,-47
2095,0,0,2,0,-2
2096,0,0,4,0,-4
2097,1,0,70,0,-70
2098,0,0,62,0,-62
2099,1,0,12,0,-12
2100,1,0,8,0,-8
2101,0,0,12,0,-12
2102,1,0,38,0,-38
2103,1,1,1533,1734,201
2104,0,0,5,0,-5
2105,0,0,32,0,-32
2106,1,1,1790,1863,73
2107,0,0,37,0,-37
2108,0,0,60,0,-60
2109,0,0,23,0,-23
2110,1,0,198,0,-198
2111,0,0,75,0,-75
2112,1,0,21,0,-21
2113,1,0,13,0,-13
2114,1,0,48,0,-48
2115,1,0,29,0,-29
2116,1,0,119,0,-119
2117,1,0,57,0,-57
2118,0,0,23,0,-23
2119,0,0,76,0,-76
2120,0,0,204,0,-204
2121,1,1,628,1443,815
2122,1,1,28,1396,1368
2123,1,1,1413,1318,-95
2124,1,0,25,0,-25
2125,1,1,150,1398,1248
2126,0,0,10,0,-10
2127,1,0,2,0,-2
2128,1,1,251,1366,1115
2129,0,0,84,0,-84
2130,0,0,3,0,-3
2131,0,0,41,0,-41
2132,1,0,26,0,-26
2133,1,0,4,0,-4
2134,1,1,661,1810,1149
2135,0,0,88,0,-88
2136,1,0,15,0,-15
2137,1,0,2,0,-2
2138,1,0,9,0,-9
2139,1,1,138,1513,1375
2140,0,0,31,0,-31
2141,1,0,2,0,-2
2142,1,1,99,1389,1290
2143,0,0,7,0,-7
2144,0,0,27,0,-27
2145,0,0,1,0,-1
2146,1,0,99,0,-99
2147,1,1,923,2222,1299
2148,1,1,799,1278,479
2149,1,1,979,1680,701
2150,1,0,37,0,-37
2151,0,0,11,0,-11
2152,0,0,12,0,-12
2153,0,0,37,0,-37
2154,1,0,17,0,-17
2155,0,0,133,0,-133
2156,0,0,51,0,-51
2157,1,0,178,0,-178
2158,1,1,554,1693,1139
2159,1,1,71,1284,1213
2160,0,0,9,0,-9
2161,1,1,139,1737,1598
2162,0,0,81,0,-81
2163,1,1,21,1826,1805
2164,1,0,68,0,-68
2165,1,0,34,0,-34
2166,0,0,12,0,-12
2167,0,0,5,0,-5
2168,1,0,93,0,-93
2169,1,0,1,0,-1
2170,1,0,53,0,-53
2171,1,0,48,0,-48
2172,1,0,50,0,-50
2173,1,1,165,1364,1199
2174,0,0,164,0,-164
2175,1,1,83,1562,1479
2176,1,1,59,1206,1147
2177,0,0,110,0,-110
2178,1,1,3300,1335,-1965
2179,0,0,11,0,-11
2180,1,1,404,1429,1025
2181,1,0,13,0,-13
2182,1,1,771,1268,497
2183,1,0,11,0,-11
2184,1,0,102,0,-102
2185,0,0,91,0,-91
2186,0,0,27,0,-27
2187,1,1,549,1914,1365
2188,1,0,152,0,-152
2189,0,0,38,0,-38
2190,0,0,30,0,-30
2191,0,0,70,0,-70
2192,1,1,479,1292,813
2193,0,0,11,0,-11
2194,1,0,12,0,-12
2195,0,0,173,0,-173
2196,1,0,19,0,-19
2197,1,0,205,0,-205
2198,1,1,372,2839,2467
2199,1,1,185,1233,1048
2200,1,0,12,0,-12
2201,1,1,2000,1657,-343
2202,0,0,162,0,-162
2203,1,1,1131,2516,1385
2204,0,0,37,0,-37
2205,0,0,117,0,-117
2206,1,0,112,0,-112
2207,1,0,20,0,-20
2208,0,0,86,0,-86
2209,1,0,157,0,-157
2210,1,0,104,0,-104
2211,1,1,508,1393,885
2212,0,0,44,0,-44
2213,1,1,447,1532,1085
2214,1,0,12,0,-12
2215,0,0,3,0,-3
2216,0,0,15,0,-15
2217,1,1,13,2244,2231
2218,1,1,355,1646,1291
2219,1,1,428,2335,1907
2220,0,0,11,0,-11
2221,0,0,75,0,-75
2222,1,1,55,1273,1218
2223,1,0,178,0,-178
2224,0,0,47,0,-47
2225,1,1,337,1224,887
2226,0,0,83,0,-83
2227,1,1,684,1599,915
2228,1,0,9,0,-9
2229,0,0,79,0,-79
2230,1,0,0,0,0
2231,0,0,32,0,-32
2232,0,0,1,0,-1
2233,1,0,55,0,-55
2234,1,0,42,0,-42
2235,1,0,73,0,-73
2236,1,1,244,1679,1435
2237,0,0,15,0,-15
2238,0,0,1,0,-1
2239,1,1,147,1246,1099
2240,1,1,274,2048,1774
2241,0,0,17,0,-17
2242,1,0,82,0,-82
2243,1,0,15,0,-15
2244,1,1,934,1264,330
2245,1,1,705,1448,743
2246,0,0,7,0,-7
2247,0,0,39,0,-39
2248,0,0,150,0,-150
2249,1,1,717,1294,577
2250,0,0,38,0,-38
2251,1,0,22,0,-22
2252,1,1,133,1211,1078
2253,0,0,14,0,-14
2254,0,0,90,0,-90
2255,1,1,751,1646,895
2256,1,1,278,1341,1063
2257,0,0,69,0,-69
2258,1,1,693,1202,509
2259,1,0,5,0,-5
2260,1,1,138,1798,1660
2261,0,0,43,0,-43
2262,1,0,35,0,-35
2263,1,1,248,1656,1408
2264,1,1,803,1463,660
2265,0,0,99,0,-99
2266,1,1,314,1420,1106
2267,0,0,13,0,-13
2268,1,0,59,0,-59
2269,0,0,38,0,-38
2270,1,0,30,0,-30
2271,0,0,0,0,0
2272,1,1,67,1404,1337
2273,1,0,2,0,-2
2274,0,0,5,0,-5
2275,0,0,62,0,-62
2276,1,1,953,1489,536
2277,1,0,21,0,-21
2278,1,0,164,0,-164
2279,0,0,35,0,-35
2280,0,0,6,0,-6
2281,1,1,281,1240,959
2282,1,1,1237,1500,263
2283,0,0,34,0,-34
2284,1,1,36,1932,1896
2285,0,0,12,0,-12
2286,1,0,140,0,-140
2287,0,0,31,0,-31
2288,1,1,992,2842,1850
2289,1,1,64,1787,1723
2290,0,0,55,0,-55
2291,0,0,36,0,-36
2292,1,1,387,1486,1099
2293,0,0,50,0,-50
2294,1,0,31,0,-31
2295,1,1,118,1248,1130
2296,1,0,85,0,-85
2297,0,0,197,0,-197
2298,1,0,2,0,-2
2299,0,0,81,0,-81
2300,1,0,51,0,-51
2301,1,1,2200,1407,-793
2302,1,1,1856,1830,-26
2303,1,1,465,3031,2566
2304,1,1,623,1254,631
2305,0,0,33,0,-33
2306,1,0,11,0,-11
2307,1,0,33,0,-33
2308,1,0,27,0,-27
2309,0,0,75,0,-75
2310,1,1,151,1391,1240
2311,1,1,256,1389,1133
2312,0,0,56,0,-56
2313,1,1,136,2665,2529
2314,1,1,919,1534,615
2315,1,1,564,1221,657
2316,1,0,1,0,-1
2317,0,0,23,0,-23
2318,1,1,3081,1235,-1846
2319,1,0,93,0,-93
2320,0,0,13,0,-13
2321,1,1,321,1827,1506
2322,0,0,30,0,-30
2323,1,0,0,0,0
2324,0,0,16,0,-16
2325,1,1,1411,1936,525
2326,1,1,585,1334,749
2327,0,0,4,0,-4
2328,1,1,274,3606,3332
2329,0,0,8,0,-8
2330,1,0,30,0,-30
2331,1,0,144,0,-144
2332,0,0,70,0,-70
2333,0,0,69,0,-69
2334,1,1,126,1385,1259
2335,1,1,530,1723,1193
2336,1,1,879,1375,496
2337,1,0,31,0,-31
2338,0,0,11,0,-11
2339,0,0,1,0,-1
2340,1,0,1,0,-1
2341,1,1,291,2713,2422
2342,0,0,33,0,-33
2343,0,0,72,0,-72
2344,1,0,126,0,-126
2345,1,1,174,1607,1433
2346,0,0,30,0,-30
2347,1,1,163,1330,1167
2348,1,0,16,0,-16
2349,1,0,0,0,0
2350,1,0,107,0,-107
2351,0,0,16,0,-16
2352,0,0,1,0,-1
2353,1,1,120,1437,1317
2354,1,0,66,0,-66
2355,1,1,649,1406,757
2356,1,0,89,0,-89
2357,0,0,46,0,-46
2358,1,0,11,0,-11
2359,1,0,80,0,-80
2360,0,0,6,0,-6
2361,1,1,211,1477,1266
2362,0,0,56,0,-56
2363,0,0,93,0,-93
2364,1,0,120,0,-120
2365,1,1,1025,1485,460
2366,1,1,1136,1949,813
2367,0,0,12,0,-12
2368,1,0,9,0,-9
2369,1,1,250,1411,1161
2370,1,1,1176,1491,315
2371,0,0,8,0,-8
2372,1,1,28,1489,1461
2373,1,0,86,0,-86
2374,1,1,530,1371,841
2375,1,0,206,0,-206
2376,1,0,88,0,-88
2377,1,1,864,2136,1272
2378,0,0,61,0,-61
2379,1,0,90,0,-90
2380,0,0,97,0,-97
2381,1,1,471,2175,1704
2382,1,1,813,1318,505
2383,1,1,62,1373,1311
2384,0,0,59,0,-59
2385,1,1,2837,1216,-1621
2386,0,0,12,0,-12
2387,1,1,215,1418,1203
2388,0,0,12,0,-12
2389,0,0,22,0,-22
2390,1,1,1488,1326,-162
2391,1,1,135,1868,1733
2392,1,1,243,2676,2433
2393,0,0,32,0,-32
2394,0,0,49,0,-49
2395,0,0,168,0,-168
2396,1,1,153,1415,1262
2397,1,1,686,2202,1516
2398,1,1,93,1378,1285
2399,0,0,6,0,-6
2400,0,0,6,0,-6
2401,1,0,93,0,-93
2402,0,0,207,0,-207
2403,0,0,40,0,-40
2404,1,1,133,1201,1068
2405,1,1,150,1253,1103
2406,0,0,67,0,-67
2407,0,0,58,0,-58
2408,1,1,67,1786,1719
2409,0,0,3,0,-3
2410,0,0,130,0,-130
2411,1,0,17,0,-17
2412,0,0,103,0,-103
2413,1,0,24,0,-24
2414,1,0,127,0,-127
2415,1,1,216,1351,1135
2416,1,1,369,1582,1213
2417,0,0,27,0,-27
2418,0,0,97,0,-97
2419,1,0,24,0,-24
2420,1,1,431,1215,784
2421,0,0,0,0,0
2422,1,1,1184,1256,72
2423,0,0,94,0,-94
2424,1,1,1443,1262,-181
2425,1,0,29,0,-29
2426,0,0,158,0,-158
2427,0,0,40,0,-40
2428,0,0,12,0,-12
2429,1,0,130,0,-130
2430,1,1,104,1402,1298
2431,1,1,260,1395,1135
2432,1,0,7,0,-7
2433,0,0,3,0,-3
2434,1,1,502,2761,2259
2435,1,0,13,0,-13
2436,0,0,58,0,-58
2437,0,0,3,0,-3
2438,0,0,123,0,-123
2439,0,0,10,0,-10
2440,0,0,184,0,-184
2441,0,0,2,0,-2
2442,0,0,61,0,-61
2443,0,0,243,0,-243
2444,1,0,9,0,-9
2445,1,0,129,0,-129
2446,1,1,218,1693,1475
2447,1,0,29,0,-29
2448,1,0,33,0,-33
2449,1,1,608,1659,1051
2450,1,0,14,0,-14
2451,1,0,46,0,-46
2452,0,0,19,0,-19
2453,1,1,124,1984,1860
2454,0,0,18,0,-18
2455,1,1,155,1227,1072
2456,1,1,254,1352,1098
2457,0,0,62,0,-62
2458,0,0,18,0,-18
2459,1,0,120,0,-120
2460,1,0,84,0,-84
2461,1,1,719,1236,517
2462,0,0,57,0,-57
2463,0,0,11,0,-11
2464,0,0,67,0,-67
2465,0,0,19,0,-19
2466,1,0,32,0,-32
2467,0,0,5,0,-5
2468,0,0,7,0,-7
2469,0,0,33,0,-33
2470,0,0,29,0,-29
2471,1,1,66,1800,1734
2472,1,0,27,0,-27
2473,0,0,55,0,-55
2474,1,1,109,1254,1145
2475,1,1,1171,1410,239
2476,1,1,99,1497,1398
2477,1,0,96,0,-96
2478,0,0,4,0,-4
2479,0,0,69,0,-69
2480,1,1,62,1775,1713
2481,1,0,14,0,-14
2482,0,0,32,0,-32
2483,0,0,62,0,-62
2484,0,0,29,0,-29
2485,1,0,21,0,-21
2486,1,1,47,1411,1364
2487,1,0,6,0,-6
2488,1,1,1356,3907,2551
2489,0,0,3,0,-3
2490,1,0,10,0,-10
2491,1,1,1320,1503,183
2492,0,0,28,0,-28
2493,1,0,13,0,-13
2494,1,1,192,1258,1066
2495,1,0,11,0,-11
2496,0,0,35,0,-35
2497,0,0,8,0,-8
2498,1,1,802,1469,667
2499,1,0,75,0,-75
2500,1,0,3,0,-3
2501,1,1,550,1298,748
2502,1,1,702,2004,1302
2503,1,0,19,0,-19
2504,1,0,37,0,-37
2505,1,1,410,1743,1333
2506,0,0,17,0,-17
2507,1,1,370,1547,1177
2508,1,1,487,1204,717
2509,1,1,197,1551,1354
2510,0,0,4,0,-4
2511,1,0,46,0,-46
2512,0,0,137,0,-137
2513,0,0,14,0,-14
2514,0,0,50,0,-50
2515,1,0,14,0,-14
2516,0,0,25,0,-25
2517,1,0,6,0,-6
2518,0,0,121,0,-121
2519,1,1,181,2876,2695
2520,0,0,26,0,-26
2521,1,1,570,1270,700
2522,1,0,92,0,-92
2523,1,1,519,1345,826
2524,1,1,323,2416,2093
2525,0,0,0,0,0
2526,0,0,14,0,-14
2527,1,0,19,0,-19
2528,1,0,56,0,-56
2529,1,0,19,0,-19
2530,0,0,56,0,-56
2531,1,0,21,0,-21
2532,1,0,29,0,-29
2533,0,0,34,0,-34
2534,0,0,0,0,0
2535,0,0,13,0,-13
2536,1,1,490,1445,955
2537,1,1,107,1772,1665
2538,0,0,31,0,-31
2539,1,0,49,0,-49
2540,1,0,204,0,-204
2541,1,0,9,0,-9
2542,1,1,31,1341,1310
2543,1,1,233,1452,1219
2544,1,1,636,1399,763
2545,0,0,28,0,-28
2546,0,0,22,0,-22
2547,1,0,202,0,-202
2548,0,0,12,0,-12
2549,1,1,282,2637,2355
2550,1,1,956,1269,313
2551,1,0,2,0,-2
2552,1,1,358,1508,1150
2553,1,0,180,0,-180
2554,1,1,1249,1447,198
2555,1,1,121,2158,2037
2556,0,0,142,0,-142
2557,1,1,84,1604,1520
2558,1,1,314,1320,1006
2559,0,0,4,0,-4
2560,0,0,77,0,-77
2561,1,1,200,1523,1323
2562,1,1,1423,1580,157
2563,1,0,58,0,-58
2564,1,0,1,0,-1
2565,1,0,1,0,-1
2566,0,0,58,0,-58
2567,1,1,784,1578,794
2568,0,0,1,0,-1
2569,1,1,1790,1201,-589
2570,0,0,29,0,-29
2571,0,0,60,0,-60
2572,1,1,261,1313,1052
2573,1,0,30,0,-30
2574,1,1,1730,1471,-259
2575,1,0,29,0,-29
2576,1,1,449,1213,764
2577,0,0,3,0,-3
2578,1,1,50,1277,1227
2579,0,0,26,0,-26
2580,0,0,41,0,-41
2581,1,0,37,0,-37
2582,1,1,273,4416,4143
2583,1,1,464,1379,915
2584,1,0,51,0,-51
2585,1,1,79,1474,1395
2586,1,1,128,1557,1429
2587,1,0,18,0,-18
2588,0,0,74,0,-74
2589,1,1,142,2051,1909
2590,0,0,193,0,-193
2591,0,0,32,0,-32
2592,0,0,37,0,-37
2593,1,1,166,1483,1317
2594,1,1,118,1809,1691
2595,1,1,249,2120,1871
2596,0,0,193,0,-193
2597,1,0,76,0,-76
2598,0,0,7,0,-7
2599,1,0,85,0,-85
2600,1,1,1182,1486,304
2601,0,0,107,0,-107
2602,0,0,14,0,-14
2603,1,0,50,0,-50
2604,1,1,127,1304,1177
2605,1,1,99,1504,1405
2606,1,1,257,1347,1090
2607,0,0,0,0,0
2608,1,1,603,2052,1449
2609,1,0,59,0,-59
2610,1,1,637,1720,1083
2611,0,0,49,0,-49
2612,1,0,46,0,-46
2613,0,0,68,0,-68
2614,0,0,13,0,-13
2615,1,1,190,1314,1124
2616,1,0,49,0,-49
2617,0,0,85,0,-85
2618,1,0,117,0,-117
2619,1,0,91,0,-91
2620,0,0,42,0,-42
2621,0,0,74,0,-74
2622,0,0,76,0,-76
2623,0,0,34,0,-34
2624,1,1,362,1311,949
2625,1,1,90,1373,1283
2626,1,1,58,1226,1168
2627,0,0,50,0,-50
2628,1,1,495,1860,1365
2629,0,0,68,0,-68
2630,1,0,20,0,-20
2631,1,1,176,1723,1547
2632,0,0,82,0,-82
2633,1,1,772,1406,634
2634,0,0,28,0,-28
2635,0,0,47,0,-47
2636,0,0,24,0,-24
2637,1,1,2152,1575,-577
2638,0,0,15,0,-15
2639,1,0,146,0,-146
2640,1,0,227,0,-227
2641,0,0,35,0,-35
2642,1,0,73,0,-73
2643,1,0,35,0,-35
2644,1,0,8,0,-8
2645,0,0,119,0,-119
2646,1,0,250,0,-250
2647,0,0,43,0,-43
2648,0,0,43,0,-43
2649,1,1,333,1564,1231
2650,1,0,1,0,-1
2651,0,0,26,0,-26
2652,0,0,26,0,-26
2653,1,0,153,0,-153
2654,1,0,63,0,-63
2655,1,0,425,0,-425
2656,1,0,0,0,0
2657,0,0,51,0,-51
2658,1,1,477,1407,930
2659,1,1,419,1335,916
2660,0,0,68,0,-68
2661,1,0,2,0,-2
2662,1,1,388,1571,1183
2663,0,0,22,0,-22
2664,1,0,16,0,-16
2665,1,1,681,1742,1061
2666,0,0,153,0,-153
2667,1,1,325,1319,994
2668,1,1,2477,1329,-1148
2669,0,0,19,0,-19
2670,1,1,2425,1514,-911
2671,0,0,23,0,-23
2672,1,1,975,1412,437
2673,0,0,40,0,-40
2674,0,0,163,0,-163
2675,1,1,1062,1693,631
2676,1,1,1153,1226,73
2677,1,0,124,0,-124
2678,0,0,77,0,-77
2679,0,0,10,0,-10
2680,0,0,24,0,-24
2681,0,0,5,0,-5
2682,0,0,31,0,-31
2683,1,1,266,1211,945
2684,1,0,55,0,-55
2685,1,0,50,0,-50
2686,1,1,15,1521,1506
2687,1,0,40,0,-40
2688,0,0,34,0,-34
2689,1,1,15,2149,2134
2690,0,0,21,0,-21
2691,0,0,19,0,-19
2692,1,0,133,0,-133
2693,1,1,516,1763,1247
2694,1,0,62,0,-62
2695,1,0,12,0,-12
2696,1,0,105,0,-105
2697,0,0,9,0,-9
2698,0,0,60,0,-60
2699,0,0,25,0,-25
2700,0,0,56,0,-56
2701,0,0,7,0,-7
2702,0,0,169,0,-169
2703,1,0,2,0,-2
2704,0,0,4,0,-4
2705,1,0,15,0,-15
2706,1,0,97,0,-97
2707,1,0,24,0,-24
2708,0,0,11,0,-11
2709,0,0,16,0,-16
2710,1,0,7,0,-7
2711,1,0,45,0,-45
2712,1,0,0,0,0
2713,1,0,20,0,-20
2714,0,0,14,0,-14
2715,0,0,2,0,-2
2716,1,0,85,0,-85
2717,1,1,403,1309,906
2718,1,1,1233,2538,1305
2719,0,0,19,0,-19
2720,0,0,9,0,-9
2721,1,0,48,0,-48
2722,0,0,49,0,-49
2723,1,0,82,0,-82
2724,1,1,1261,2037,776
2725,1,0,36,0,-36
2726,0,0,10,0,-10
2727,0,0,2,0,-2
2728,0,0,9,0,-9
2729,1,1,1134,1507,373
2730,0,0,5,0,-5
2731,0,0,19,0,-19
2732,0,0,112,0,-112
2733,0,0,29,0,-29
2734,0,0,47,0,-47
2735,1,1,467,1216,749
2736,1,1,138,1813,1675
2737,1,0,15,0,-15
2738,1,0,52,0,-52
2739,0,0,0,0,0
2740,1,0,13,0,-13
2741,0,0,123,0,-123
2742,1,1,127,1512,1385
2743,1,1,1800,1494,-306
2744,0,0,176,0,-176
2745,1,0,0,0,0
2746,0,0,43,0,-43
2747,1,1,290,1786,1496
2748,1,0,4,0,-4
2749,0,0,40,0,-40
2750,0,0,11,0,-11
2751,1,0,55,0,-55
2752,0,0,12,0,-12
2753,0,0,96,0,-96
2754,1,0,24,0,-24
2755,0,0,41,0,-41
2756,0,0,8,0,-8
2757,1,0,48,0,-48
2758,1,0,52,0,-52
2759,1,0,27,0,-27
2760,1,0,9,0,-9
2761,1,1,36,1445,1409
2762,1,0,178,0,-178
2763,0,0,110,0,-110
2764,0,0,30,0,-30
2765,0,0,5,0,-5
2766,1,0,65,0,-65
2767,1,1,42,1220,1178
2768,1,1,107,1685,1578
2769,1,1,2194,1420,-774
2770,1,0,17,0,-17
2771,0,0,26,0,-26
2772,1,1,1071,1287,216
2773,1,0,44,0,-44
2774,0,0,8,0,-8
2775,1,1,191,1614,1423
2776,1,0,18,0,-18
2777,1,0,27,0,-27
2778,1,0,17,0,-17
2779,0,0,134,0,-134
2780,1,0,18,0,-18
2781,0,0,2,0,-2
2782,1,1,851,1988,1137
2783,0,0,29,0,-29
2784,0,0,3,0,-3
2785,1,1,151,1452,1301
2786,1,0,33,0,-33
2787,0,0,31,0,-31
2788,1,1,207,1252,1045
2789,1,0,2,0,-2
2790,1,1,499,1454,955
2791,0,0,25,0,-25
2792,1,0,12,0,-12
2793,0,0,43,0,-43
2794,0,0,184,0,-184
2795,1,1,101,1545,1444
2796,0,0,28,0,-28
2797,1,0,61,0,-61
2798,1,1,52,1246,1194
2799,0,0,46,0,-46
2800,0,0,23,0,-23
2801,1,1,307,1565,1258
2802,0,0,58,0,-58
2803,0,0,98,0,-98
2804,0,0,56,0,-56
2805,1,0,36,0,-36
2806,1,0,39,0,-39
2807,1,0,192,0,-192
2808,0,0,37,0,-37
2809,0,0,187,0,-187
2810,1,1,657,1234,577
2811,1,1,332,2067,1735
2812,1,1,1029,1229,200
2813,1,1,102,1207,1105
2814,0,0,84,0,-84
2815,1,0,52,0,-52
2816,0,0,81,0,-81
2817,0,0,18,0,-18
2818,0,0,71,0,-71
2819,0,0,2,0,-2
2820,1,1,448,1482,1034
2821,1,0,10,0,-10
2822,1,1,222,1203,981
2823,1,0,22,0,-22
2824,1,0,18,0,-18
2825,1,0,115,0,-115
2826,0,0,15,0,-15
2827,1,0,141,0,-141
2828,1,1,558,1526,968
2829,1,1,455,1304,849
2830,0,0,2,0,-2
2831,1,1,419,1366,947
2832,1,0,118,0,-118
2833,1,0,282,0,-282
2834,1,1,65,2431,2366
2835,0,0,28,0,-28
2836,1,0,27,0,-27
2837,0,0,5,0,-5
2838,1,1,118,1973,1855
2839,0,0,64,0,-64
2840,1,1,213,1985,1772
2841,0,0,79,0,-79
2842,1,0,89,0,-89
2843,0,0,15,0,-15
2844,0,0,34,0,-34
2845,0,0,8,0,-8
2846,1,0,46,0,-46
2847,1,0,0,0,0
2848,0,0,10,0,-10
2849,1,0,38,0,-38
2850,1,0,31,0,-31
2851,0,0,93,0,-93
2852,1,1,542,2038,1496
2853,1,0,1,0,-1
2854,1,0,138,0,-138
2855,1,1,299,1701,1402
2856,1,1,13,1976,1963
2857,1,0,38,0,-38
2858,1,1,410,1226,816
2859,1,0,82,0,-82
2860,1,0,33,0,-33
2861,1,0,11,0,-11
2862,1,1,43,1415,1372
2863,0,0,4,0,-4
2864,1,1,16,1633,1617
2865,1,1,827,1554,727
2866,1,0,32,0,-32
2867,0,0,14,0,-14
2868,1,1,72,1762,1690
2869,1,0,28,0,-28
2870,1,1,860,1339,479
2871,0,0,48,0,-48
2872,1,0,52,0,-52
2873,1,0,90,0,-90
2874,1,0,23,0,-23
2875,0,0,120,0,-120
2876,1,0,5,0,-5
2877,0,0,122,0,-122
2878,1,0,2,0,-2
2879,0,0,189,0,-189
2880,1,1,783,1253,470
2881,1,1,1522,1836,314
2882,1,0,45,0,-45
2883,1,0,43,0,-43
2884,0,0,39,0,-39
2885,0,0,20,0,-20
2886,0,0,33,0,-33
2887,0,0,195,0,-195
2888,1,0,27,0,-27
2889,0,0,43,0,-43
2890,0,0,68,0,-68
2891,0,0,43,0,-43
2892,0,0,36,0,-36
2893,0,0,102,0,-102
2894,1,1,38,1815,1777
2895,1,1,626,1357,731
2896,1,0,206,0,-206
2897,0,0,66,0,-66
2898,1,1,272,1418,1146
2899,1,1,334,1228,894
2900,1,0,4,0,-4
2901,0,0,0,0,0
2902,1,1,513,1308,795
2903,1,0,155,0,-155
2904,1,1,306,1641,1335
2905,1,1,346,1389,1043
2906,0,0,46,0,-46
2907,1,1,335,1454,1119
2908,1,0,5,0,-5
2909,0,0,36,0,-36
2910,1,0,33,0,-33
2911,1,0,40,0,-40
2912,1,1,433,1235,802
2913,1,1,863,1671,808
2914,1,1,813,1528,715
2915,1,0,76,0,-76
2916,0,0,7,0,-7
2917,1,1,3021,1324,-1697
2918,0,0,75,0,-75
2919,0,0,44,0,-44
2920,1,0,176,0,-176
2921,0,0,46,0,-46
2922,0,0,109,0,-109
2923,1,1,129,1516,1387
2924,1,1,398,1321,923
2925,0,0,45,0,-45
2926,0,0,23,0,-23
2927,0,0,27,0,-27
2928,0,0,37,0,-37
2929,0,0,104,0,-104
2930,1,0,45,0,-45
2931,1,0,50,0,-50
2932,0,0,22,0,-22
2933,1,0,62,0,-62
2934,1,0,2,0,-2
2935,1,0,58,0,-58
2936,0,0,13,0,-13
2937,1,1,110,1570,1460
2938,1,0,40,0,-40
2939,0,0,70,0,-70
2940,1,0,2,0,-2
2941,0,0,8,0,-8
2942,1,1,6,1379,1373
2943,0,0,70,0,-70
2944,1,1,281,1382,1101
2945,1,0,188,0,-188
2946,1,1,1009,1495,486
2947,1,1,727,1255,528
2948,0,0,1,0,-1
2949,1,0,79,0,-79
2950,1,1,253,2018,1765
2951,0,0,34,0,-34
2952,0,0,51,0,-51
2953,1,1,20,1248,1228
2954,1,0,71,0,-71
2955,1,0,77,0,-77
2956,0,0,19,0,-19
2957,0,0,168,0,-168
2958,1,1,1406,2627,1221
2959,0,0,3,0,-3
2960,1,0,25,0,-25
2961,1,0,14,0,-14
2962,1,1,440,1403,963
2963,1,0,16,0,-16
2964,0,0,30,0,-30
2965,1,1,760,1948,1188
2966,1,1,40,1417,1377
2967,1,1,302,1629,1327
2968,1,0,30,0,-30
2969,1,1,133,1801,1668
2970,1,1,292,2352,2060
2971,0,0,23,0,-23
2972,0,0,36,0,-36
2973,1,0,17,0,-17
2974,1,1,463,2113,1650
2975,1,0,18,0,-18
2976,0,0,16,0,-16
2977,0,0,27,0,-27
2978,0,0,19,0,-19
2979,1,0,35,0,-35
2980,0,0,137,0,-137
2981,1,0,54,0,-54
2982,1,1,718,1995,1277
2983,0,0,124,0,-124
2984,1,0,40,0,-40
2985,1,0,86,0,-86
2986,1,0,85,0,-85
2987,0,0,11,0,-11
2988,0,0,209,0,-209
2989,0,0,4,0,-4
2990,1,1,1682,1205,-477
2991,1,0,11,0,-11
2992,1,0,90,0,-90
2993,1,0,0,0,0
2994,1,0,14,0,-14
2995,0,0,45,0,-45
2996,0,0,37,0,-37
2997,0,0,109,0,-109
2998,0,0,5,0,-5
2999,0,0,7,0,-7
3000,1,0,45,0,-45
3001,1,0,8,0,-8
3002,0,0,9,0,-9
3003,1,1,550,1677,1127
3004,1,0,42,0,-42
3005,0,0,47,0,-47
3006,1,0,71,0,-71
3007,0,0,10,0,-10
3008,1,1,90,1352,1262
3009,0,0,10,0,-10
3010,0,0,72,0,-72
3011,0,0,2,0,-2
3012,0,0,57,0,-57
3013,0,0,0,0,0
3014,1,1,1422,1742,320
3015,0,0,40,0,-40
3016,0,0,44,0,-44
3017,0,0,66,0,-66
3018,1,1,2061,1275,-786
3019,1,1,282,1259,977
3020,0,0,24,0,-24
3021,0,0,93,0,-93
3022,1,0,27,0,-27
3023,1,0,92,0,-92
3024,0,0,46,0,-46
3025,0,0,2,0,-2
3026,0,0,43,0,-43
3027,0,0,39,0,-39
3028,1,1,1495,1409,-86
3029,0,0,27,0,-27
3030,0,0,29,0,-29
3031,1,1,278,1508,1230
3032,1,1,1220,2854,1634
3033,0,0,19,0,-19
3034,1,1,595,1416,821
3035,1,1,187,2189,2002
3036,1,1,72,1268,1196
3037,0,0,18,0,-18
3038,1,0,25,0,-25
3039,1,1,1381,1363,-18
3040,1,1,1821,1237,-584
3041,1,1,211,1204,993
3042,1,0,83,0,-83
3043,1,1,1103,1794,691
3044,1,1,312,1310,998
3045,0,0,0,0,0
3046,1,1,282,1374,1092
3047,0,0,51,0,-51
3048,1,0,49,0,-49
3049,1,0,19,0,-19
3050,0,0,40,0,-40
3051,1,1,589,1950,1361
3052,1,0,15,0,-15
3053,0,0,89,0,-89
3054,1,1,967,1464,497
3055,1,1,154,1493,1339
3056,1,0,99,0,-99
3057,0,0,86,0,-86
3058,1,1,874,1970,1096
3059,1,0,35,0,-35
3060,0,0,2,0,-2
3061,0,0,23,0,-23
3062,1,1,114,2265,2151
3063,1,1,305,1204,899
3064,1,0,107,0,-107
3065,0,0,33,0,-33
3066,0,0,36,0,-36
3067,0,0,34,0,-34
3068,1,0,141,0,-141
3069,1,0,41,0,-41
3070,1,1,268,1244,976
3071,1,1,376,1255,879
3072,0,0,2,0,-2
3073,0,0,35,0,-35
3074,1,0,83,0,-83
3075,0,0,24,0,-24
3076,1,1,735,1582,847
3077,0,0,22,0,-22
3078,0,0,127,0,-127
3079,0,0,23,0,-23
3080,0,0,70,0,-70
3081,1,0,10,0,-10
3082,0,0,7,0,-7
3083,1,1,1072,1446,374
3084,0,0,9,0,-9
3085,1,1,522,1201,679
3086,1,0,21,0,-21
3087,1,1,2080,1234,-846
3088,1,1,348,1224,876
3089,1,0,6,0,-6
3090,1,0,6,0,-6
3091,1,1,690,1359,669
3092,1,1,192,1596,1404
3093,0,0,99,0,-99
3094,1,1,965,1615,650
3095,1,0,67,0,-67
3096,1,0,43,0,-43
3097,0,0,3,0,-3
3098,1,0,18,0,-18
3099,1,0,37,0,-37
3100,1,1,164,1441,1277
3101,1,0,38,0,-38
3102,0,0,42,0,-42
3103,1,1,110,2376,2266
3104,0,0,35,0,-35
3105,1,0,60,0,-60
3106,1,1,278,1302,1024
3107,0,0,14,0,-14
3108,1,1,1453,1425,-28
3109,0,0,45,0,-45
3110,1,1,1399,1324,-75
3111,0,0,52,0,-52
3112,1,0,5,0,-5
3113,0,0,14,0,-14
3114,0,0,57,0,-57
3115,1,0,62,0,-62
3116,0,0,48,0,-48
3117,1,0,2,0,-2
3118,0,0,2,0,-2
3119,1,0,18,0,-18
3120,1,1,631,1453,822
3121,0,0,48,0,-48
3122,1,0,26,0,-26
3123,1,0,31,0,-31
3124,1,0,50,0,-50
3125,1,0,43,0,-43
3126,1,1,82,2466,2384
3127,1,0,22,0,-22
3128,1,1,532,3253,2721
3129,0,0,115,0,-115
3130,0,0,48,0,-48
3131,1,0,19,0,-19
3132,0,0,116,0,-116
3133,0,0,34,0,-34
3134,1,1,610,1722,1112
3135,0,0,55,0,-55
3136,1,0,5,0,-5
3137,1,1,729,1221,492
3138,0,0,12,0,-12
3139,1,0,51,0,-51
3140,1,0,68,0,-68
3141,1,1,158,1359,1201
3142,1,1,100,1356,1256
3143,0,0,9,0,-9
3144,1,1,186,1325,1139
3145,0,0,0,0,0
3146,1,1,121,1298,1177
3147,1,1,705,1931,1226
3148,1,1,768,1200,432
3149,1,0,12,0,-12
3150,0,0,3,0,-3
3151,1,1,507,1402,895
3152,1,0,26,0,-26
3153,1,1,145,1981,1836
3154,1,0,15,0,-15
3155,0,0,100,0,-100
3156,1,1,216,1385,1169
3157,1,0,57,0,-57
3158,1,0,25,0,-25
3159,0,0,18,0,-18
3160,0,0,3,0,-3
3161,0,0,28,0,-28
3162,0,0,19,0,-19
3163,1,0,29,0,-29
3164,1,1,341,1454,1113
3165,0,0,36,0,-36
3166,0,0,36,0,-36
3167,1,0,20,0,-20
3168,1,1,605,2123,1518
3169,1,1,965,1243,278
3170,1,1,1378,1322,-56
3171,0,0,58,0,-58
3172,1,0,4,0,-4
3173,1,1,473,1210,737
3174,0,0,15,0,-15
3175,0,0,37,0,-37
3176,1,1,288,1248,960
3177,1,1,331,1213,882
3178,0,0,4,0,-4
3179,1,1,1352,1363,11
3180,1,0,69,0,-69
3181,0,0,27,0,-27
3182,1,0,3,0,-3
3183,0,0,11,0,-11
3184,0,0,26,0,-26
3185,1,1,201,1790,1589
3186,0,0,24,0,-24
3187,1,1,657,1276,619
3188,1,1,365,1700,1335
3189,1,0,10,0,-10
3190,1,1,470,1417,947
3191,1,1,353,1283,930
3192,1,0,32,0,-32
3193,0,0,1,0,-1
3194,0,0,202,0,-202
3195,1,0,33,0,-33
3196,0,0,157,0,-157
3197,0,0,51,0,-51
3198,0,0,23,0,-23
3199,0,0,8,0,-8
3200,0,0,44,0,-44
3201,1,1,1010,1266,256
3202,1,0,0,0,0
3203,1,0,12,0,-12
3204,0,0,6,0,-6
3205,0,0,31,0,-31
3206,1,0,16,0,-16
3207,1,0,35,0,-35
3208,0,0,202,0,-202
3209,1,0,21,0,-21
3210,0,0,26,0,-26
3211,0,0,46,0,-46
3212,0,0,28,0,-28
3213,0,0,27,0,-27
3214,1,0,15,0,-15
3215,1,0,37,0,-37
3216,0,0,114,0,-114
3217,1,1,65,1321,1256
3218,0,0,25,0,-25
3219,0,0,99,0,-99
3220,1,1,936,1218,282
3221,1,1,187,1297,1110
3222,1,1,78,1694,1616
3223,0,0,21,0,-21
3224,1,0,81,0,-81
3225,0,0,40,0,-40
3226,0,0,15,0,-15
3227,1,1,82,1488,1406
3228,1,1,220,1643,1423
3229,1,1,1613,1310,-303
3230,1,0,63,0,-63
3231,1,1,372,1270,898
3232,0,0,7,0,-7
3233,1,0,20,0,-20
3234,1,1,137,1661,1524
3235,0,0,24,0,-24
3236,0,0,9,0,-9
3237,0,0,12,0,-12
3238,0,0,8,0,-8
3239,1,0,9,0,-9
3240,0,0,38,0,-38
3241,0,0,141,0,-141
3242,1,0,91,0,-91
3243,1,1,110,1494,1384
3244,1,0,49,0,-49
3245,1,1,243,1256,1013
3246,0,0,7,0,-7
3247,1,1,250,1546,1296
3248,0,0,94,0,-94
3249,0,0,58,0,-58
3250,0,0,44,0,-44
3251,1,1,1064,2745,1681
3252,0,0,8,0,-8
3253,1,0,17,0,-17
3254,0,0,1,0,-1
3255,0,0,62,0,-62
3256,0,0,14,0,-14
3257,1,1,184,1457,1273
3258,0,0,9,0,-9
3259,1,0,107,0,-107
3260,1,1,142,1698,1556
3261,0,0,117,0,-117
3262,1,1,289,1522,1233
3263,1,1,563,1737,1174
3264,1,1,214,1495,1281
3265,1,1,200,1222,1022
3266,1,0,0,0,0
3267,0,0,13,0,-13
3268,0,0,25,0,-25
3269,1,0,21,0,-21
3270,0,0,2,0,-2
3271,1,0,18,0,-18
3272,0,0,20,0,-20
3273,0,0,18,0,-18
3274,0,0,2,0,-2
3275,1,0,36,0,-36
3276,1,1,174,1238,1064
3277,1,1,762,1500,738
3278,1,1,776,1212,436
3279,1,1,2741,1358,-1383
3280,1,1,586,1762,1176
3281,1,0,69,0,-69
3282,1,0,24,0,-24
3283,1,1,184,1811,1627
3284,1,0,78,0,-78
3285,0,0,21,0,-21
3286,0,0,27,0,-27
3287,0,0,6,0,-6
3288,0,0,44,0,-44
3289,0,0,37,0,-37
3290,1,0,218,0,-218
3291,1,1,674,1455,781
3292,0,0,151,0,-151
3293,1,1,277,1237,960
3294,1,0,6,0,-6
3295,1,0,37,0,-37
3296,0,0,28,0,-28
3297,0,0,18,0,-18
3298,0,0,10,0,-10
3299,0,0,42,0,-42
3300,1,0,217,0,-217
3301,1,0,81,0,-81
3302,1,1,226,1206,980
3303,0,0,75,0,-75
3304,0,0,8,0,-8
3305,0,0,15,0,-15
3306,0,0,59,0,-59
3307,1,0,76,0,-76
3308,1,1,170,1260,1090
3309,0,0,96,0,-96
3310,0,0,96,0,-96
3311,1,1,920,1439,519
3312,1,1,839,1322,483
3313,0,0,108,0,-108
3314,0,0,14,0,-14
3315,0,0,49,0,-49
3316,0,0,32,0,-32
3317,0,0,4,0,-4
3318,1,1,60,1419,1359
3319,1,1,468,3485,3017
3320,0,0,46,0,-46
3321,1,1,180,1346,1166
3322,1,1,180,1789,1609
3323,0,0,16,0,-16
3324,1,0,61,0,-61
3325,0,0,6,0,-6
3326,0,0,35,0,-35
3327,1,0,21,0,-21
3328,1,1,935,1387,452
3329,1,0,38,0,-38
3330,1,1,803,1731,928
3331,1,1,251,1894,1643
3332,1,0,63,0,-63
3333,1,0,59,0,-59
3334,1,0,116,0,-116
3335,1,0,100,0,-100
3336,0,0,30,0,-30
3337,1,1,300,1398,1098
3338,1,1,52,1425,1373
3339,1,1,1564,1230,-334
3340,1,1,588,1338,750
3341,0,0,15,0,-15
3342,1,0,140,0,-140
3343,1,1,180,1302,1122
3344,1,0,49,0,-49
3345,1,0,46,0,-46
3346,0,0,50,0,-50
3347,0,0,10,0,-10
3348,1,1,427,1204,777
3349,1,0,56,0,-56
3350,1,0,4,0,-4
3351,1,0,7,0,-7
3352,0,0,43,0,-43
3353,0,0,45,0,-45
3354,1,1,591,1311,720
3355,0,0,10,0,-10
3356,1,1,342,1368,1026
3357,1,1,359,1407,1048
3358,0,0,23,0,-23
3359,0,0,23,0,-23
3360,1,0,109,0,-109
3361,0,0,52,0,-52
3362,1,1,142,1305,1163
3363,0,0,104,0,-104
3364,0,0,73,0,-73
3365,1,0,81,0,-81
3366,0,0,61,0,-61
3367,0,0,60,0,-60
3368,1,0,88,0,-88
3369,0,0,129,0,-129
3370,0,0,36,0,-36
3371,0,0,19,0,-19
3372,0,0,83,0,-83
3373,1,0,17,0,-17
3374,1,1,413,1302,889
3375,0,0,54,0,-54
3376,0,0,62,0,-62
3377,1,1,583,1308,725
3378,1,1,467,1559,1092
3379,1,1,326,1225,899
3380,0,0,41,0,-41
3381,1,0,37,0,-37
3382,1,1,1034,2704,1670
3383,1,0,196,0,-196
3384,0,0,53,0,-53
3385,0,0,52,0,-52
3386,1,0,85,0,-85
3387,1,1,95,1505,1410
3388,1,1,703,1411,708
3389,0,0,2,0,-2
3390,0,0,25,0,-25
3391,1,1,162,2185,2023
3392,0,0,8,0,-8
3393,1,1,722,1587,865
3394,1,1,703,1678,975
3395,0,0,2,0,-2
3396,0,0,55,0,-55
3397,0,0,11,0,-11
3398,1,1,352,1260,908
3399,1,0,55,0,-55
3400,1,0,15,0,-15
3401,1,0,92,0,-92
3402,1,1,489,1696,1207
3403,0,0,6,0,-6
3404,1,1,34,1329,1295
3405,1,0,30,0,-30
3406,1,0,0,0,0
3407,0,0,1,0,-1
3408,1,0,47,0,-47
3409,0,0,0,0,0
3410,1,1,1911,1546,-365
3411,1,1,133,1624,1491
3412,1,1,567,1429,862
3413,0,0,20,0,-20
3414,1,1,844,1460,616
3415,0,0,92,0,-92
3416,0,0,41,0,-41
3417,0,0,10,0,-10
3418,0,0,63,0,-63
3419,1,0,18,0,-18
3420,1,0,23,0,-23
3421,1,0,38,0,-38
3422,1,1,514,1203,689
3423,0,0,9,0,-9
3424,0,0,47,0,-47
3425,0,0,7,0,-7
3426,1,1,273,1289,1016
3427,0,0,2,0,-2
3428,1,1,166,1274,1108
3429,0,0,63,0,-63
3430,1,1,47,1856,1809
3431,0,0,5,0,-5
3432,1,0,33,0,-33
3433,1,0,28,0,-28
3434,0,0,3,0,-3
3435,1,0,80,0,-80
3436,0,0,6,0,-6
3437,1,1,1261,1772,511
3438,1,1,765,1549,784
3439,0,0,68,0,-68
3440,0,0,69,0,-69
3441,1,1,1065,1245,180
3442,1,0,20,0,-20
3443,0,0,61,0,-61
3444,1,0,73,0,-73
3445,1,1,358,1954,1596
3446,1,1,264,1486,1222
3447,1,0,78,0,-78
3448,0,0,27,0,-27
3449,1,1,213,1238,1025
3450,0,0,13,0,-13
3451,0,0,21,0,-21
3452,1,0,2,0,-2
3453,1,0,48,0,-48
3454,0,0,39,0,-39
3455,1,1,976,1205,229
3456,1,1,116,2009,1893
3457,0,0,82,0,-82
3458,0,0,151,0,-151
3459,0,0,143,0,-143
3460,1,1,1366,2043,677
3461,0,0,143,0,-143
3462,1,0,68,0,-68
3463,0,0,54,0,-54
3464,0,0,179,0,-179
3465,0,0,27,0,-27
3466,1,0,79,0,-79
3467,1,1,360,1329,969
3468,0,0,45,0,-45
3469,1,0,45,0,-45
3470,1,0,67,0,-67
3471,1,1,339,1361,1022
3472,1,1,1918,1992,74
3473,1,0,78,0,-78
3474,1,0,76,0,-76
3475,1,0,3,0,-3
3476,1,1,1074,1863,789
3477,1,1,913,1682,769
3478,1,0,37,0,-37
3479,1,1,463,1964,1501
3480,1,1,1542,1566,24
3481,0,0,17,0,-17
3482,1,1,635,1923,1288
3483,0,0,147,0,-147
3484,1,0,8,0,-8
3485,0,0,52,0,-52
3486,1,1,1607,1933,326
3487,1,0,59,0,-59
3488,0,0,11,0,-11
3489,1,0,164,0,-164
3490,1,1,1245,1225,-20
3491,1,0,82,0,-82
3492,0,0,105,0,-105
3493,0,0,21,0,-21
3494,1,1,444,1269,825
3495,1,1,118,2015,1897
3496,0,0,14,0,-14
3497,0,0,2,0,-2
3498,1,0,126,0,-126
3499,0,0,24,0,-24
3500,0,0,38,0,-38
3501,0,0,54,0,-54
3502,1,1,100,1225,1125
3503,0,0,26,0,-26
3504,1,0,54,0,-54
3505,1,0,30,0,-30
3506,1,0,127,0,-127
3507,0,0,23,0,-23
3508,0,0,55,0,-55
3509,0,0,7,0,-7
3510,1,0,23,0,-23
3511,1,1,670,1564,894
3512,0,0,27,0,-27
3513,1,1,588,1315,727
3514,0,0,8,0,-8
3515,1,1,265,1615,1350
3516,0,0,28,0,-28
3517,0,0,66,0,-66
3518,1,0,72,0,-72
3519,0,0,2,0,-2
3520,0,0,79,0,-79
3521,0,0,79,0,-79
3522,0,0,17,0,-17
3523,1,1,1706,1311,-395
3524,0,0,40,0,-40
3525,1,1,211,1738,1527
3526,1,1,448,1530,1082
3527,0,0,21,0,-21
3528,0,0,5,0,-5
3529,1,0,139,0,-139
3530,1,1,192,1813,1621
3531,0,0,7,0,-7
3532,1,0,61,0,-61
3533,1,1,346,1200,854
3534,0,0,48,0,-48
3535,0,0,31,0,-31
3536,1,0,16,0,-16
3537,1,1,650,1334,684
3538,0,0,51,0,-51
3539,1,0,17,0,-17
3540,1,1,1698,1792,94
3541,1,1,663,1580,917
3542,1,1,95,1357,1262
3543,1,1,460,1341,881
3544,0,0,81,0,-81
3545,1,0,63,0,-63
3546,1,0,8,0,-8
3547,1,0,36,0,-36
3548,0,0,71,0,-71
3549,1,1,62,1270,1208
3550,1,0,13,0,-13
3551,0,0,6,0,-6
3552,1,0,8,0,-8
3553,1,1,278,1358,1080
3554,0,0,28,0,-28
3555,0,0,10,0,-10
3556,1,1,1461,1422,-39
3557,0,0,126,0,-126
3558,0,0,7,0,-7
3559,0,0,6,0,-6
3560,0,0,41,0,-41
3561,1,0,39,0,-39
3562,1,0,15,0,-15
3563,0,0,15,0,-15
3564,0,0,85,0,-85
3565,1,0,20,0,-20
3566,1,0,16,0,-16
3567,0,0,49,0,-49
3568,0,0,16,0,-16
3569,0,0,104,0,-104
3570,1,0,16,0,-16
3571,1,0,171,0,-171
3572,1,0,8,0,-8
3573,0,0,51,0,-51
3574,1,0,45,0,-45
3575,0,0,30,0,-30
3576,0,0,27,0,-27
3577,0,0,155,0,-155
3578,0,0,123,0,-123
3579,0,0,81,0,-81
3580,0,0,64,0,-64
3581,0,0,111,0,-111
3582,1,1,215,1209,994
3583,1,0,17,0,-17
3584,1,1,135,1265,1130
3585,1,1,246,1237,991
3586,0,0,15,0,-15
3587,0,0,15,0,-15
3588,1,0,8,0,-8
3589,1,0,67,0,-67
3590,1,1,712,1974,1262
3591,1,0,47,0,-47
3592,1,0,59,0,-59
3593,1,1,462,1616,1154
3594,1,0,10,0,-10
3595,0,0,39,0,-39
3596,1,0,194,0,-194
3597,0,0,15,0,-15
3598,0,0,47,0,-47
3599,1,0,43,0,-43
3600,0,0,1,0,-1
3601,1,0,143,0,-143
3602,0,0,48,0,-48
3603,0,0,71,0,-71
3604,1,0,69,0,-69
3605,0,0,16,0,-16
3606,1,1,207,1641,1434
3607,1,0,4,0,-4
3608,1,1,16,1573,1557
3609,1,1,580,1281,701
3610,0,0,10,0,-10
3611,0,0,62,0,-62
3612,1,0,25,0,-25
3613,1,0,3,0,-3
3614,1,1,1262,1714,452
3615,1,1,1097,1361,264
3616,1,0,15,0,-15
3617,0,0,5,0,-5
3618,1,1,370,1265,895
3619,1,0,71,0,-71
3620,1,1,7,1347,1340
3621,0,0,178,0,-178
3622,1,1,658,1390,732
3623,1,1,506,1347,841
3624,1,1,276,2996,2720
3625,1,1,919,1477,558
3626,0,0,8,0,-8
3627,0,0,104,0,-104
3628,1,0,37,0,-37
3629,1,1,136,1287,1151
3630,1,0,11,0,-11
3631,1,1,251,1752,1501
3632,1,1,243,1608,1365
3633,1,1,275,1630,1355
3634,0,0,61,0,-61
3635,1,0,15,0,-15
3636,1,1,367,2342,1975
3637,0,0,42,0,-42
3638,0,0,5,0,-5
3639,1,0,21,0,-21
3640,1,1,305,2770,2465
3641,1,0,35,0,-35
3642,0,0,1,0,-1
3643,0,0,77,0,-77
3644,1,0,12,0,-12
3645,1,0,63,0,-63
3646,1,1,99,1828,1729
3647,0,0,10,0,-10
3648,1,1,669,1335,666
3649,0,0,4,0,-4
3650,0,0,149,0,-149
3651,1,1,1289,1450,161
3652,1,1,1096,1295,199
3653,0,0,30,0,-30
3654,1,1,462,1424,962
3655,1,1,64,1319,1255
3656,1,1,8,1622,1614
3657,1,1,15,1315,1300
3658,1,1,863,3604,2741
3659,1,0,0,0,0
3660,1,1,159,1243,1084
3661,0,0,13,0,-13
3662,1,0,55,0,-55
3663,1,0,2,0,-2
3664,1,1,890,1225,335
3665,1,0,16,0,-16
3666,1,1,2089,1209,-880
3667,1,0,43,0,-43
3668,0,0,159,0,-159
3669,0,0,16,0,-16
3670,0,0,28,0,-28
3671,0,0,18,0,-18
3672,1,0,46,0,-46
3673,1,0,57,0,-57
3674,1,1,680,1368,688
3675,0,0,25,0,-25
3676,1,1,175,2265,2090
3677,0,0,0,0,0
3678,0,0,4,0,-4
3679,1,1,522,1599,1077
3680,1,1,191,1591,1400
3681,0,0,52,0,-52
3682,1,1,498,1605,1107
3683,0,0,57,0,-57
3684,0,0,88,0,-88
3685,1,0,19,0,-19
3686,0,0,52,0,-52
3687,1,1,653,1751,1098
3688,0,0,55,0,-55
3689,1,0,4,0,-4
3690,0,0,7,0,-7
3691,0,0,69,0,-69
3692,0,0,2,0,-2
3693,1,1,460,1371,911
3694,0,0,3,0,-3
3695,1,1,967,1851,884
3696,1,1,717,1616,899
3697,1,0,6,0,-6
3698,1,0,6,0,-6
3699,0,0,23,0,-23
3700,0,0,0,0,0
3701,1,1,110,1603,1493
3702,1,1,1164,1597,433
3703,1,0,15,0,-15
3704,1,0,149,0,-149
3705,1,1,388,2404,2016
3706,1,0,60,0,-60
3707,1,1,786,1207,421
3708,1,1,420,1343,923
3709,0,0,171,0,-171
3710,1,1,648,1376,728
3711,1,1,693,1280,587
3712,0,0,57,0,-57
3713,1,0,32,0,-32
3714,0,0,89,0,-89
3715,1,1,245,1474,1229
3716,1,0,93,0,-93
3717,0,0,52,0,-52
3718,1,0,36,0,-36
3719,1,0,101,0,-101
3720,0,0,13,0,-13
3721,1,0,6,0,-6
3722,0,0,85,0,-85
3723,0,0,27,0,-27
3724,1,0,22,0,-22
3725,1,0,163,0,-163
3726,1,1,345,2466,2121
3727,0,0,32,0,-32
3728,0,0,50,0,-50
3729,0,0,6,0,-6
3730,1,1,88,2310,2222
3731,1,0,42,0,-42
3732,1,1,373,1674,1301
3733,0,0,47,0,-47
3734,0,0,20,0,-20
3735,1,1,287,1986,1699
3736,1,0,57,0,-57
3737,0,0,24,0,-24
3738,1,0,28,0,-28
3739,1,0,25,0,-25
3740,1,0,45,0,-45
3741,1,1,287,1865,1578
3742,1,0,9,0,-9
3743,1,0,44,0,-44
3744,1,0,147,0,-147
3745,0,0,102,0,-102
3746,1,0,63,0,-63
3747,1,0,180,0,-180
3748,1,0,3,0,-3
3749,0,0,75,0,-75
3750,0,0,22,0,-22
3751,0,0,22,0,-22
3752,1,0,9,0,-9
3753,1,0,179,0,-179
3754,1,0,66,0,-66
3755,0,0,41,0,-41
3756,1,0,46,0,-46
3757,0,0,11,0,-11
3758,1,0,56,0,-56
3759,1,0,6,0,-6
3760,0,0,177,0,-177
3761,1,1,78,1254,1176
3762,0,0,6,0,-6
3763,1,1,76,1978,1902
3764,0,0,94,0,-94
3765,1,0,299,0,-299
3766,1,1,134,1302,1168
3767,0,0,7,0,-7
3768,1,1,86,1770,1684
3769,1,1,324,1209,885
3770,0,0,186,0,-186
3771,0,0,7,0,-7
3772,1,0,6,0,-6
3773,0,0,109,0,-109
3774,1,1,1234,2038,804
3775,1,0,43,0,-43
3776,0,0,7,0,-7
3777,0,0,28,0,-28
3778,0,0,54,0,-54
3779,0,0,83,0,-83
3780,1,1,593,1289,696
3781,0,0,38,0,-38
3782,1,1,303,2250,1947
3783,1,1,325,1259,934
3784,0,0,116,0,-116
3785,1,0,73,0,-73
3786,1,1,221,3321,3100
3787,1,0,57,0,-57
3788,1,1,139,1420,1281
3789,1,1,132,1284,1152
3790,1,1,697,1596,899
3791,0,0,118,0,-118
3792,1,0,48,0,-48
3793,0,0,75,0,-75
3794,0,0,9,0,-9
3795,1,0,28,0,-28
3796,1,1,1484,1360,-124
3797,1,0,94,0,-94
3798,1,1,927,1252,325
3799,1,1,56,2934,2878
3800,1,0,59,0,-59
3801,0,0,75,0,-75
3802,1,1,552,1658,1106
3803,0,0,30,0,-30
3804,1,0,241,0,-241
3805,0,0,4,0,-4
3806,1,1,1185,1938,753
3807,0,0,69,0,-69
3808,0,0,30,0,-30
3809,0,0,23,0,-23
3810,0,0,49,0,-49
3811,1,1,1601,1609,8
3812,1,1,186,1656,1470
3813,0,0,162,0,-162
3814,1,0,8,0,-8
3815,1,1,39,2059,2020
3816,1,1,1112,1383,271
3817,1,0,11,0,-11
3818,1,1,1068,1240,172
3819,1,1,1246,1329,83
3820,1,0,1,0,-1
3821,1,1,467,1554,1087
3822,1,1,313,1419,1106
3823,0,0,123,0,-123
3824,1,0,49,0,-49
3825,0,0,286,0,-286
3826,1,0,49,0,-49
3827,1,1,146,1807,1661
3828,0,0,52,0,-52
3829,1,0,25,0,-25
3830,0,0,224,0,-224
3831,1,0,3,0,-3
3832,1,1,1008,1323,315
3833,1,1,77,6979,6902
3834,1,1,119,1543,1424
3835,1,1,835,1209,374
3836,1,1,302,1269,967
3837,0,0,60,0,-60
3838,1,0,26,0,-26
3839,1,0,36,0,-36
3840,1,1,1448,1349,-99
3841,0,0,97,0,-97
3842,1,0,24,0,-24
3843,1,1,282,1731,1449
3844,1,1,206,1847,1641
3845,0,0,55,0,-55
3846,0,0,70,0,-70
3847,1,0,122,0,-122
3848,1,1,286,1204,918
3849,1,0,29,0,-29
3850,0,0,14,0,-14
3851,1,0,197,0,-197
3852,0,0,239,0,-239
3853,1,1,857,1453,596
3854,0,0,119,0,-119
3855,1,1,197,1689,1492
3856,1,0,95,0,-95
3857,0,0,82,0,-82
3858,0,0,93,0,-93
3859,1,0,100,0,-100
3860,1,0,78,0,-78
3861,0,0,28,0,-28
3862,0,0,21,0,-21
3863,1,1,678,1382,704
3864,1,1,166,1330,1164
3865,1,0,42,0,-42
3866,1,0,78,0,-78
3867,0,0,146,0,-146
3868,0,0,56,0,-56
3869,1,0,10,0,-10
3870,0,0,3,0,-3
3871,0,0,94,0,-94
3872,1,0,0,0,0
3873,0,0,30,0,-30
3874,0,0,24,0,-24
3875,0,0,18,0,-18
3876,1,0,61,0,-61
3877,0,0,72,0,-72
3878,0,0,18,0,-18
3879,0,0,9,0,-9
3880,1,1,88,1457,1369
3881,0,0,7,0,-7
3882,1,0,113,0,-113
3883,1,1,1890,1257,-633
3884,1,1,262,1268,1006
3885,1,1,509,1801,1292
3886,1,0,21,0,-21
3887,1,0,1,0,-1
3888,1,0,51,0,-51
3889,1,1,245,1446,1201
3890,0,0,10,0,-10
3891,0,0,128,0,-128
3892,1,0,100,0,-100
3893,0,0,53,0,-53
3894,1,1,222,1775,1553
3895,1,0,69,0,-69
3896,1,1,924,1259,335
3897,1,1,161,1429,1268
3898,1,1,1266,1404,138
3899,1,0,13,0,-13
3900,1,1,71,1371,1300
3901,0,0,58,0,-58
3902,1,0,23,0,-23
3903,1,1,160,1243,1083
3904,0,0,222,0,-222
3905,0,0,2,0,-2
3906,0,0,58,0,-58
3907,1,0,7,0,-7
3908,1,0,16,0,-16
3909,1,1,98,1264,1166
3910,1,0,149,0,-149
3911,1,1,571,1214,643
3912,1,1,163,1619,1456
3913,1,1,491,1216,725
3914,0,0,99,0,-99
3915,1,0,72,0,-72
3916,1,0,138,0,-138
3917,0,0,10,0,-10
3918,0,0,17,0,-17
3919,1,1,277,1411,1134
3920,1,1,1543,1431,-112
3921,1,1,349,1266,917
3922,0,0,80,0,-80
3923,0,0,36,0,-36
3924,0,0,8,0,-8
3925,0,0,16,0,-16
3926,1,0,14,0,-14
3927,0,0,28,0,-28
3928,0,0,76,0,-76
3929,1,1,506,1318,812
3930,1,1,66,1281,1215
3931,1,1,425,1275,850
3932,1,1,1856,1265,-591
3933,1,1,352,1651,1299
3934,0,0,102,0,-102
3935,0,0,5,0,-5
3936,1,0,6,0,-6
3937,1,1,867,1593,726
3938,0,0,74,0,-74
3939,0,0,68,0,-68
3940,0,0,17,0,-17
3941,1,1,1114,1335,221
3942,0,0,40,0,-40
3943,1,1,162,1496,1334
3944,1,0,93,0,-93
3945,1,0,81,0,-81
3946,1,1,168,1827,1659
3947,0,0,80,0,-80
3948,1,1,42,2132,2090
3949,1,1,472,2025,1553
3950,1,0,15,0,-15
3951,1,1,555,1458,903
3952,1,0,3,0,-3
3953,1,1,612,1339,727
3954,1,0,36,0,-36
3955,0,0,91,0,-91
3956,1,0,26,0,-26
3957,0,0,8,0,-8
3958,0,0,5,0,-5
3959,0,0,53,0,-53
3960,0,0,17,0,-17
3961,1,1,596,1405,809
3962,0,0,1,0,-1
3963,1,0,11,0,-11
3964,1,0,228,0,-228
3965,0,0,32,0,-32
3966,1,0,31,0,-31
3967,0,0,17,0,-17
3968,0,0,45,0,-45
3969,0,0,400,0,-400
3970,1,0,32,0,-32
3971,1,0,18,0,-18
3972,1,0,27,0,-27
3973,0,0,47,0,-47
3974,1,0,54,0,-54
3975,1,1,530,1448,918
3976,1,1,340,1739,1399
3977,0,0,100,0,-100
3978,1,0,104,0,-104
3979,1,1,129,1548,1419
3980,1,1,560,1865,1305
3981,0,0,21,0,-21
3982,0,0,105,0,-105
3983,0,0,73,0,-73
3984,1,1,420,1813,1393
3985,1,1,69,1357,1288
3986,0,0,27,0,-27
3987,0,0,36,0,-36
3988,1,1,451,1743,1292
3989,1,0,55,0,-55
3990,0,0,24,0,-24
3991,1,1,272,2347,2075
3992,0,0,35,0,-35
3993,1,0,88,0,-88
3994,1,1,139,1423,1284
3995,0,0,18,0,-18
3996,1,0,9,0,-9
3997,1,0,67,0,-67
3998,0,0,118,0,-118
3999,1,1,139,3544,3405
4000,0,0,3,0,-3
4001,1,1,403,1244,841
4002,1,1,322,1529,1207
4003,0,0,168,0,-168
4004,1,1,579,1349,770
4005,0,0,59,0,-59
4006,0,0,9,0,-9
4007,1,1,664,1296,632
4008,1,1,279,1232,953
4009,0,0,3,0,-3
4010,0,0,196,0,-196
4011,0,0,36,0,-36
4012,0,0,15,0,-15
4013,0,0,10,0,-10
4014,1,0,129,0,-129
4015,1,1,377,1402,1025
4016,1,1,299,2063,1764
4017,1,0,26,0,-26
4018,1,1,140,2336,2196
4019,1,0,3,0,-3
4020,1,0,35,0,-35
4021,0,0,6,0,-6
4022,1,1,473,1341,868
4023,0,0,4,0,-4
4024,0,0,75,0,-75
4025,0,0,3,0,-3
4026,0,0,17,0,-17
4027,1,1,463,1699,1236
4028,1,0,7,0,-7
4029,0,0,8,0,-8
4030,0,0,7,0,-7
4031,0,0,23,0,-23
4032,0,0,6,0,-6
4033,1,0,41,0,-41
4034,1,0,29,0,-29
4035,0,0,63,0,-63
4036,0,0,43,0,-43
4037,1,0,41,0,-41
4038,0,0,86,0,-86
4039,0,0,140,0,-140
4040,1,0,67,0,-67
4041,0,0,14,0,-14
4042,1,0,36,0,-36
4043,1,0,25,0,-25
4044,1,1,168,1808,1640
4045,1,0,26,0,-26
4046,1,1,427,1276,849
4047,0,0,15,0,-15
4048,1,1,193,1540,1347
4049,1,1,432,1211,779
4050,1,1,768,1231,463
4051,1,0,11,0,-11
4052,1,0,4,0,-4
4053,0,0,83,0,-83
4054,1,0,0,0,0
4055,0,0,94,0,-94
4056,0,0,93,0,-93
4057,0,0,4,0,-4
4058,0,0,55,0,-55
4059,1,1,247,1586,1339
4060,1,1,87,1292,1205
4061,0,0,16,0,-16
4062,1,1,71,2606,2535
4063,1,1,1168,1675,507
4064,1,0,93,0,-93
4065,1,1,217,1657,1440
4066,0,0,39,0,-39
4067,1,0,38,0,-38
4068,1,1,193,1477,1284
4069,0,0,64,0,-64
4070,0,0,41,0,-41
4071,0,0,22,0,-22
4072,1,0,19,0,-19
4073,0,0,31,0,-31
4074,1,1,870,1546,676
4075,1,1,290,1243,953
4076,1,1,206,1492,1286
4077,1,0,1,0,-1
4078,1,1,154,1261,1107
4079,1,0,42,0,-42
4080,0,0,42,0,-42
4081,0,0,9,0,-9
4082,1,0,5,0,-5
4083,1,1,294,1518,1224
4084,0,0,9,0,-9
4085,0,0,147,0,-147
4086,1,0,81,0,-81
4087,0,0,70,0,-70
4088,1,1,421,2939,2518
4089,0,0,51,0,-51
4090,1,1,655,1543,888
4091,1,0,33,0,-33
4092,0,0,10,0,-10
4093,1,1,617,1546,929
4094,1,0,33,0,-33
4095,0,0,2,0,-2
4096,1,1,307,1631,1324
4097,0,0,16,0,-16
4098,0,0,15,0,-15
4099,0,0,35,0,-35
4100,0,0,17,0,-17
4101,0,0,21,0,-21
4102,0,0,389,0,-389
4103,0,0,73,0,-73
4104,0,0,84,0,-84
4105,0,0,9,0,-9
4106,1,1,577,1235,658
4107,0,0,29,0,-29
4108,1,0,53,0,-53
4109,0,0,185,0,-185
4110,1,0,6,0,-6
4111,1,1,1495,1392,-103
4112,0,0,42,0,-42
4113,1,1,191,1205,1014
4114,1,1,366,1968,1602
4115,1,1,217,2710,2493
4116,1,1,715,1221,506
4117,1,0,84,0,-84
4118,0,0,93,0,-93
4119,0,0,13,0,-13
4120,0,0,20,0,-20
4121,0,0,16,0,-16
4122,0,0,17,0,-17
4123,1,0,184,0,-184
4124,0,0,47,0,-47
4125,0,0,12,0,-12
4126,0,0,33,0,-33
4127,1,1,868,2081,1213
4128,0,0,5,0,-5
4129,1,1,358,3343,2985
4130,1,1,1088,1581,493
4131,0,0,79,0,-79
4132,1,0,179,0,-179
4133,1,0,52,0,-52
4134,1,1,848,1479,631
4135,0,0,13,0,-13
4136,0,0,12,0,-12
4137,1,1,789,1232,443
4138,1,0,100,0,-100
4139,0,0,142,0,-142
4140,1,1,1544,1727,183
4141,0,0,27,0,-27
4142,0,0,6,0,-6
4143,0,0,82,0,-82
4144,1,0,127,0,-127
4145,1,0,4,0,-4
4146,1,1,124,1351,1227
4147,0,0,16,0,-16
4148,1,1,10,3662,3652
4149,0,0,51,0,-51
4150,0,0,103,0,-103
4151,0,0,3,0,-3
4152,1,1,1125,1271,146
4153,1,1,711,1466,755
4154,1,1,52,3307,3255
4155,0,0,3,0,-3
4156,1,0,16,0,-16
4157,1,0,16,0,-16
4158,1,1,49,1314,1265
4159,1,1,604,1560,956
4160,1,1,780,1330,550
4161,0,0,9,0,-9
4162,1,0,4,0,-4
4163,1,1,208,1580,1372
4164,0,0,193,0,-193
4165,1,1,483,2972,2489
4166,0,0,15,0,-15
4167,1,0,50,0,-50
4168,1,0,141,0,-141
4169,0,0,38,0,-38
4170,1,1,547,1319,772
4171,1,1,800,1261,461
4172,0,0,176,0,-176
4173,0,0,48,0,-48
4174,1,1,94,1757,1663
4175,1,1,1348,1645,297
4176,0,0,37,0,-37
4177,1,0,68,0,-68
4178,1,1,338,2276,1938
4179,1,0,3,0,-3
4180,0,0,69,0,-69
4181,1,1,608,1398,790
4182,1,1,52,1280,1228
4183,1,0,9,0,-9
4184,1,0,5,0,-5
4185,1,0,27,0,-27
4186,1,1,114,1218,1104
4187,0,0,96,0,-96
4188,0,0,66,0,-66
4189,1,1,251,1235,984
4190,1,1,349,1699,1350
4191,0,0,127,0,-127
4192,1,1,150,1456,1306
4193,1,0,74,0,-74
4194,0,0,4,0,-4
4195,1,0,83,0,-83
4196,1,0,14,0,-14
4197,1,0,21,0,-21
4198,0,0,0,0,0
4199,0,0,28,0,-28
4200,0,0,1,0,-1
4201,1,0,3,0,-3
4202,1,1,71,1256,1185
4203,1,1,213,1876,1663
4204,0,0,66,0,-66
4205,1,0,31,0,-31
4206,1,1,1642,1477,-165
4207,0,0,31,0,-31
4208,0,0,32,0,-32
4209,0,0,59,0,-59
4210,1,1,677,1372,695
4211,0,0,95,0,-95
4212,1,0,306,0,-306
4213,1,0,19,0,-19
4214,0,0,6,0,-6
4215,0,0,27,0,-27
4216,0,0,12,0,-12
4217,1,1,37,1221,1184
4218,0,0,7,0,-7
4219,1,0,40,0,-40
4220,1,0,32,0,-32
4221,1,0,4,0,-4
4222,0,0,36,0,-36
4223,0,0,30,0,-30
4224,0,0,21,0,-21
4225,0,0,18,0,-18
4226,0,0,13,0,-13
4227,1,0,158,0,-158
4228,0,0,172,0,-172
4229,1,1,690,1222,532
4230,0,0,249,0,-249
4231,0,0,11,0,-11
4232,0,0,61,0,-61
4233,1,1,1364,1311,-53
4234,1,1,88,1639,1551
4235,0,0,166,0,-166
4236,1,0,38,0,-38
4237,1,1,495,1330,835
4238,1,1,277,1614,1337
4239,1,1,151,1428,1277
4240,0,0,2,0,-2
4241,1,1,390,1657,1267
4242,1,1,1682,1322,-360
4243,1,0,60,0,-60
4244,0,0,23,0,-23
4245,1,0,169,0,-169
4246,1,1,422,3569,3147
4247,0,0,2,0,-2
4248,1,1,277,1243,966
4249,0,0,11,0,-11
4250,0,0,1,0,-1
4251,0,0,2,0,-2
4252,1,1,664,1363,699
4253,0,0,31,0,-31
4254,0,0,85,0,-85
4255,1,0,18,0,-18
4256,1,1,775,1363,588
4257,0,0,11,0,-11
4258,1,1,159,1206,1047
4259,1,1,891,1368,477
4260,0,0,46,0,-46
4261,1,0,6,0,-6
4262,1,1,318,1505,1187
4263,1,1,193,1426,1233
4264,1,1,1245,1910,665
4265,1,0,4,0,-4
4266,1,1,470,1231,761
4267,1,0,0,0,0
4268,0,0,4,0,-4
4269,1,1,170,1536,1366
4270,0,0,60,0,-60
4271,0,0,6,0,-6
4272,0,0,16,0,-16
4273,1,1,509,1987,1478
4274,1,0,36,0,-36
4275,0,0,44,0,-44
4276,1,1,234,1350,1116
4277,0,0,40,0,-40
4278,0,0,15,0,-15
4279,1,1,797,1378,581
4280,1,1,1568,1469,-99
4281,1,1,318,1209,891
4282,0,0,19,0,-19
4283,1,0,50,0,-50
4284,1,0,60,0,-60
4285,0,0,113,0,-113
4286,0,0,3,0,-3
4287,1,1,827,2312,1485
4288,0,0,27,0,-27
4289,1,1,170,1562,1392
4290,1,1,153,1654,1501
4291,0,0,33,0,-33
4292,1,0,25,0,-25
4293,0,0,24,0,-24
4294,0,0,6,0,-6
4295,1,1,989,1957,968
4296,1,0,132,0,-132
4297,1,0,27,0,-27
4298,1,0,82,0,-82
4299,1,1,3437,1543,-1894
4300,1,0,103,0,-103
4301,0,0,0,0,0
4302,1,1,560,2176,1616
4303,1,1,842,1378,536
4304,1,0,8,0,-8
4305,1,0,14,0,-14
4306,1,1,153,2764,2611
4307,0,0,20,0,-20
4308,1,0,169,0,-169
4309,1,1,62,1832,1770
4310,1,1,549,1394,845
4311,0,0,91,0,-91
4312,0,0,6,0,-6
4313,1,0,2,0,-2
4314,1,0,54,0,-54
4315,0,0,35,0,-35
4316,1,1,1413,1317,-96
4317,0,0,9,0,-9
4318,0,0,55,0,-55
4319,0,0,30,0,-30
4320,0,0,88,0,-88
4321,1,0,12,0,-12
4322,1,0,6,0,-6
4323,0,0,28,0,-28
4324,0,0,10,0,-10
4325,1,1,217,1313,1096
4326,1,0,108,0,-108
4327,1,0,104,0,-104
4328,0,0,75,0,-75
4329,1,1,1570,1570,0
4330,1,0,40,0,-40
4331,1,1,141,1726,1585
4332,0,0,21,0,-21
4333,0,0,79,0,-79
4334,0,0,16,0,-16
4335,1,1,946,1420,474
4336,0,0,11,0,-11
4337,1,0,18,0,-18
4338,1,0,12,0,-12
4339,0,0,38,0,-38
4340,1,1,64,1331,1267
4341,1,0,88,0,-88
4342,0,0,27,0,-27
4343,0,0,71,0,-71
4344,0,0,0,0,0
4345,0,0,43,0,-43
4346,0,0,17,0,-17
4347,1,0,17,0,-17
4348,0,0,0,0,0
4349,1,0,168,0,-168
4350,0,0,217,0,-217
4351,0,0,0,0,0
4352,0,0,19,0,-19
4353,1,1,99,1240,1141
4354,0,0,78,0,-78
4355,0,0,126,0,-126
4356,0,0,60,0,-60
4357,1,1,1032,1787,755
4358,0,0,92,0,-92
4359,0,0,13,0,-13
4360,0,0,83,0,-83
4361,0,0,7,0,-7
4362,1,1,203,1230,1027
4363,1,0,36,0,-36
4364,0,0,170,0,-170
4365,0,0,28,0,-28
4366,1,0,178,0,-178
4367,1,1,233,2314,2081
4368,1,1,196,2335,2139
4369,0,0,8,0,-8
4370,0,0,1,0,-1
4371,1,1,123,1566,1443
4372,0,0,38,0,-38
4373,1,1,265,1689,1424
4374,1,0,134,0,-134
4375,1,1,923,2102,1179
4376,1,0,90,0,-90
4377,0,0,6,0,-6
4378,1,0,10,0,-10
4379,1,1,693,1217,524
4380,1,1,1766,1257,-509
4381,1,1,183,1251,1068
4382,0,0,9,0,-9
4383,1,1,197,1471,1274
4384,0,0,30,0,-30
4385,0,0,30,0,-30
4386,1,0,32,0,-32
4387,0,0,9,0,-9
4388,1,0,29,0,-29
4389,0,0,8,0,-8
4390,1,1,626,1534,908
4391,0,0,12,0,-12
4392,0,0,17,0,-17
4393,0,0,22,0,-22
4394,1,1,937,1335,398
4395,1,1,878,1235,357
4396,1,0,17,0,-17
4397,1,0,3,0,-3
4398,0,0,128,0,-128
4399,0,0,3,0,-3
4400,1,1,825,2622,1797
4401,0,0,19,0,-19
4402,1,1,1603,1312,-291
4403,0,0,111,0,-111
4404,0,0,52,0,-52
4405,0,0,76,0,-76
4406,1,0,108,0,-108
4407,0,0,6,0,-6
4408,1,0,41,0,-41
4409,1,0,24,0,-24
4410,1,0,2,0,-2
4411,1,1,320,1296,976
4412,1,0,7,0,-7
4413,1,0,7,0,-7
4414,0,0,18,0,-18
4415,1,1,15,1954,1939
4416,1,1,252,1597,1345
4417,1,1,746,1411,665
4418,1,0,40,0,-40
4419,1,0,12,0,-12
4420,0,0,4,0,-4
4421,1,0,38,0,-38
4422,1,1,660,1265,605
4423,1,0,49,0,-49
4424,0,0,0,0,0
4425,0,0,5,0,-5
4426,1,0,6,0,-6
4427,1,0,52,0,-52
4428,1,0,34,0,-34
4429,0,0,110,0,-110
4430,1,0,69,0,-69
4431,0,0,3,0,-3
4432,1,0,56,0,-56
4433,1,0,99,0,-99
4434,0,0,12,0,-12
4435,0,0,9,0,-9
4436,1,1,609,1246,637
4437,1,0,22,0,-22
4438,0,0,93,0,-93
4439,0,0,69,0,-69
4440,0,0,125,0,-125
4441,0,0,47,0,-47
4442,0,0,1,0,-1
4443,0,0,58,0,-58
4444,0,0,26,0,-26
4445,1,1,283,2313,2030
4446,0,0,23,0,-23
4447,0,0,16,0,-16
4448,0,0,72,0,-72
4449,0,0,41,0,-41
4450,0,0,47,0,-47
4451,0,0,27,0,-27
4452,1,1,184,1292,1108
4453,1,1,172,1249,1077
4454,1,1,50,1647,1597
4455,1,1,225,1334,1109
4456,0,0,115,0,-115
4457,0,0,2,0,-2
4458,1,1,195,2132,1937
4459,0,0,56,0,-56
4460,1,1,284,2535,2251
4461,1,0,2,0,-2
